id,start.date,start.rating,end.date,end.rating,time,start.year,end.year,,,,,,id,start.date,start.rating,end.date,end.rating
1,40541,6,42366,6,1825,2010,2015,,2009,2015,44191,46016,1,36891,6,38716,6
2,41412,6,42366,6,954,2013,2015,,2015,,45062,46016,2,37762,6,38716,6
3,40174,5,40479,6,305,2009,2010,,,,43824,44129,3,36524,5,36829,6
3,40479,6,40905,5,426,2010,2011,,,,44129,44555,3,36829,6,37255,5
3,40905,5,42366,5,1461,2011,2015,,,,44555,46016,3,37255,5,38716,5
4,40905,5,41056,6,151,2011,2012,,,,44555,44706,4,37255,5,37406,6
4,41056,6,42366,6,1310,2012,2015,,,,44706,46016,4,37406,6,38716,6
5,40320,2,40691,3,371,2010,2011,,,,43970,44341,5,36670,2,37041,3
5,40691,3,40844,2,153,2011,2011,,,,44341,44494,5,37041,3,37194,2
5,40844,2,42366,2,1522,2011,2015,,,,44494,46016,5,37194,2,38716,2
6,40174,4,40905,4,731,2009,2011,,,,43824,44555,6,36524,4,37255,4
6,40905,4,42366,4,1461,2011,2015,,,,44555,46016,6,37255,4,38716,4
7,41270,4,41445,5,175,2012,2013,,,,44920,45095,7,37620,4,37795,5
7,41445,5,41635,6,190,2013,2013,,,,45095,45285,7,37795,5,37985,6
7,41635,6,41778,5,143,2013,2014,,,,45285,45428,7,37985,6,38128,5
7,41778,5,42366,5,588,2014,2015,,,,45428,46016,7,38128,5,38716,5
8,41270,3,42366,3,1096,2012,2015,,,,44920,46016,8,37620,3,38716,3
10,42001,5,42366,5,365,2014,2015,,,,45651,46016,10,38351,5,38716,5
11,40174,6,40905,7,731,2009,2011,,,,43824,44555,11,36524,6,37255,7
11,40905,7,41047,8,142,2011,2012,,,,44555,44697,11,37255,7,37397,8
13,40174,4,41421,5,1247,2009,2013,,,,43824,45071,13,36524,4,37771,5
13,41421,5,42366,5,945,2013,2015,,,,45071,46016,13,37771,5,38716,5
14,40074,5,40174,5,100,2009,2009,,,,43724,43824,14,36424,5,36524,5
14,40174,5,40905,5,731,2009,2011,,,,43824,44555,14,36524,5,37255,5
14,40905,5,41052,6,147,2011,2012,,,,44555,44702,14,37255,5,37402,6
14,41052,6,41778,5,726,2012,2014,,,,44702,45428,14,37402,6,38128,5
14,41778,5,42366,5,588,2014,2015,,,,45428,46016,14,38128,5,38716,5
15,41635,4,42366,4,731,2013,2015,,,,45285,46016,15,37985,4,38716,4
17,39991,3,42366,3,2375,2009,2015,,,,43641,46016,17,36341,3,38716,3
18,39982,6,41810,6,1828,2009,2014,,,,43632,45460,18,36332,6,38160,6
18,41810,6,42366,6,556,2014,2015,,,,45460,46016,18,38160,6,38716,6
20,40540,5,40752,6,212,2010,2011,,,,44190,44402,20,36890,5,37102,6
20,40752,6,42366,6,1614,2011,2015,,,,44402,46016,20,37102,6,38716,6
21,40348,2,42366,2,2018,2010,2015,,,,43998,46016,21,36698,2,38716,2
22,42001,8,42366,8,365,2014,2015,,,,45651,46016,22,38351,8,38716,8
23,39960,5,42244,5,2284,2009,2015,,,,43610,45894,23,36310,5,38594,5
23,42244,5,42366,5,122,2015,2015,,,,45894,46016,23,38594,5,38716,5
25,40326,4,40440,3,114,2010,2010,,,,43976,44090,25,36676,4,36790,3
25,40440,3,42366,3,1926,2010,2015,,,,44090,46016,25,36790,3,38716,3
26,40174,4,41778,4,1604,2009,2014,,,,43824,45428,26,36524,4,38128,4
26,41778,4,42366,4,588,2014,2015,,,,45428,46016,26,38128,4,38716,4
27,41787,2,42366,2,579,2014,2015,,,,45437,46016,27,38137,2,38716,2
28,42001,4,42366,4,365,2014,2015,,,,45651,46016,28,38351,4,38716,4
29,40510,3,42366,3,1856,2010,2015,,,,44160,46016,29,36860,3,38716,3
30,40905,1,41412,3,507,2011,2013,,,,44555,45062,30,37255,1,37762,3
30,41412,3,41635,5,223,2013,2013,,,,45062,45285,30,37762,3,37985,5
32,41535,3,42366,3,831,2013,2015,,,,45185,46016,32,37885,3,38716,3
34,40326,2,41270,3,944,2010,2012,,,,43976,44920,34,36676,2,37620,3
34,41270,3,41421,3,151,2012,2013,,,,44920,45071,34,37620,3,37771,3
34,41421,3,42366,3,945,2013,2015,,,,45071,46016,34,37771,3,38716,3
35,41270,3,41870,3,600,2012,2014,,,,44920,45520,35,37620,3,38220,3
35,41870,3,42366,3,496,2014,2015,,,,45520,46016,35,38220,3,38716,3
36,40326,4,42366,4,2040,2010,2015,,,,43976,46016,36,36676,4,38716,4
37,42001,2,42366,2,365,2014,2015,,,,45651,46016,37,38351,2,38716,2
38,40540,3,41574,3,1034,2010,2013,,,,44190,45224,38,36890,3,37924,3
38,41574,3,42366,3,792,2013,2015,,,,45224,46016,38,37924,3,38716,3
39,40317,2,41049,1,732,2010,2012,,,,43967,44699,39,36667,2,37399,1
39,41049,1,42366,1,1317,2012,2015,,,,44699,46016,39,37399,1,38716,1
40,40144,3,41626,3,1482,2009,2013,,,,43794,45276,40,36494,3,37976,3
40,41626,3,41635,3,9,2013,2013,,,,45276,45285,40,37976,3,37985,3
40,41635,3,42366,3,731,2013,2015,,,,45285,46016,40,37985,3,38716,3
42,41818,3,42366,3,548,2014,2015,,,,45468,46016,42,38168,3,38716,3
43,40691,3,40713,4,22,2011,2011,,,,44341,44363,43,37041,3,37063,4
43,40713,4,41047,4,334,2011,2012,,,,44363,44697,43,37063,4,37397,4
43,41047,4,42366,5,1319,2012,2015,,,,44697,46016,43,37397,4,38716,5
43,41047,5,41056,6,9,2012,2012,,,,44697,44706,43,37397,5,37406,6
43,41056,6,41870,5,814,2012,2014,,,,44706,45520,43,37406,6,38220,5
43,41870,5,42152,5,282,2014,2015,,,,45520,45802,43,38220,5,38502,5
43,42152,5,42366,5,214,2015,2015,,,,45802,46016,43,38502,5,38716,5
44,42152,4,42366,4,214,2015,2015,,,,45802,46016,44,38502,4,38716,4
45,41056,1,42366,1,1310,2012,2015,,,,44706,46016,45,37406,1,38716,1
46,39960,2,40783,2,823,2009,2011,,,,43610,44433,46,36310,2,37133,2
46,40783,2,41270,2,487,2011,2012,,,,44433,44920,46,37133,2,37620,2
46,41270,2,41635,3,365,2012,2013,,,,44920,45285,46,37620,2,37985,3
46,41635,3,42366,3,731,2013,2015,,,,45285,46016,46,37985,3,38716,3
47,41270,4,41421,4,151,2012,2013,,,,44920,45071,47,37620,4,37771,4
47,41421,4,42366,4,945,2013,2015,,,,45071,46016,47,37771,4,38716,4
48,39960,4,42366,4,2406,2009,2015,,,,43610,46016,48,36310,4,38716,4
49,41056,2,42366,2,1310,2012,2015,,,,44706,46016,49,37406,2,38716,2
50,40318,3,42366,3,2048,2010,2015,,,,43968,46016,50,36668,3,38716,3
52,40144,4,40165,4,21,2009,2009,,,,43794,43815,52,36494,4,36515,4
52,40165,4,41056,3,891,2009,2012,,,,43815,44706,52,36515,4,37406,3
52,41056,3,42366,3,1310,2012,2015,,,,44706,46016,52,37406,3,38716,3
53,40326,2,42366,2,2040,2010,2015,,,,43976,46016,53,36676,2,38716,2
54,40531,6,40844,7,313,2010,2011,,,,44181,44494,54,36881,6,37194,7
54,40844,7,41117,8,273,2011,2012,,,,44494,44767,54,37194,7,37467,8
56,41056,5,41421,6,365,2012,2013,,,,44706,45071,56,37406,5,37771,6
56,41421,6,42366,6,945,2013,2015,,,,45071,46016,56,37771,6,38716,6
57,39960,3,40682,3,722,2009,2011,,,,43610,44332,57,36310,3,37032,3
58,41809,2,42366,2,557,2014,2015,,,,45459,46016,58,38159,2,38716,2
59,41787,4,42366,4,579,2014,2015,,,,45437,46016,59,38137,4,38716,4
60,40019,5,40510,5,491,2009,2010,,,,43669,44160,60,36369,5,36860,5
61,40415,4,42366,4,1951,2010,2015,,,,44065,46016,61,36765,4,38716,4
62,39951,3,41635,3,1684,2009,2013,,,,43601,45285,62,36301,3,37985,3
62,41635,3,42366,3,731,2013,2015,,,,45285,46016,62,37985,3,38716,3
63,40083,3,41421,3,1338,2009,2013,,,,43733,45071,63,36433,3,37771,3
63,41421,3,42366,3,945,2013,2015,,,,45071,46016,63,37771,3,38716,3
64,41117,5,41421,4,304,2012,2013,,,,44767,45071,64,37467,5,37771,4
64,41421,4,42366,4,945,2013,2015,,,,45071,46016,64,37771,4,38716,4
65,40317,5,40691,5,374,2010,2011,,,,43967,44341,65,36667,5,37041,5
65,40691,5,41270,4,579,2011,2012,,,,44341,44920,65,37041,5,37620,4
65,41270,4,41787,4,517,2012,2014,,,,44920,45437,65,37620,4,38137,4
65,41787,4,42366,4,579,2014,2015,,,,45437,46016,65,38137,4,38716,4
66,41818,4,42366,4,548,2014,2015,,,,45468,46016,66,38168,4,38716,4
67,40326,3,41421,3,1095,2010,2013,,,,43976,45071,67,36676,3,37771,3
67,41421,3,41818,4,397,2013,2014,,,,45071,45468,67,37771,3,38168,4
67,41818,4,41940,4,122,2014,2014,,,,45468,45590,67,38168,4,38290,4
67,41940,4,42001,4,61,2014,2014,,,,45590,45651,67,38290,4,38351,4
67,42001,4,42366,4,365,2014,2015,,,,45651,46016,67,38351,4,38716,4
68,41875,4,42366,4,491,2014,2015,,,,45525,46016,68,38225,4,38716,4
69,40479,3,42366,3,1887,2010,2015,,,,44129,46016,69,36829,3,38716,3
70,40357,3,41209,4,852,2010,2012,,,,44007,44859,70,36707,3,37559,4
70,41209,4,42366,4,1157,2012,2015,,,,44859,46016,70,37559,4,38716,4
71,42001,4,42366,4,365,2014,2015,,,,45651,46016,71,38351,4,38716,4
72,39954,4,41047,4,1093,2009,2012,,,,43604,44697,72,36304,4,37397,4
72,41047,4,42366,4,1319,2012,2015,,,,44697,46016,72,37397,4,38716,4
73,39960,5,40540,5,580,2009,2010,,,,43610,44190,73,36310,5,36890,5
73,40540,5,41270,4,730,2010,2012,,,,44190,44920,73,36890,5,37620,4
73,41270,4,42366,4,1096,2012,2015,,,,44920,46016,73,37620,4,38716,4
74,40019,5,40326,5,307,2009,2010,,,,43669,43976,74,36369,5,36676,5
74,40326,5,41056,4,730,2010,2012,,,,43976,44706,74,36676,5,37406,4
74,41056,4,42366,4,1310,2012,2015,,,,44706,46016,74,37406,4,38716,4
75,40113,3,41421,3,1308,2009,2013,,,,43763,45071,75,36463,3,37771,3
75,41421,3,42366,3,945,2013,2015,,,,45071,46016,75,37771,3,38716,3
76,41056,3,41473,3,417,2012,2013,,,,44706,45123,76,37406,3,37823,3
77,40752,4,41544,6,792,2011,2013,,,,44402,45194,77,37102,4,37894,6
77,41544,6,41635,6,91,2013,2013,,,,45194,45285,77,37894,6,37985,6
77,41635,6,42366,6,731,2013,2015,,,,45285,46016,77,37985,6,38716,6
78,41270,1,42366,1,1096,2012,2015,,,,44920,46016,78,37620,1,38716,1
79,41787,2,42366,2,579,2014,2015,,,,45437,46016,79,38137,2,38716,2
81,40905,3,41087,4,182,2011,2012,,,,44555,44737,81,37255,3,37437,4
81,41087,4,42366,4,1279,2012,2015,,,,44737,46016,81,37437,4,38716,4
82,40722,4,41412,4,690,2011,2013,,,,44372,45062,82,37072,4,37762,4
82,41412,4,42366,4,954,2013,2015,,,,45062,46016,82,37762,4,38716,4
83,39951,5,40174,5,223,2009,2009,,,,43601,43824,83,36301,5,36524,5
83,40174,5,40866,6,692,2009,2011,,,,43824,44516,83,36524,5,37216,6
83,40866,6,41047,6,181,2011,2012,,,,44516,44697,83,37216,6,37397,6
83,41047,6,42366,6,1319,2012,2015,,,,44697,46016,83,37397,6,38716,6
85,42001,4,42366,4,365,2014,2015,,,,45651,46016,85,38351,4,38716,4
86,40531,5,41635,5,1104,2010,2013,,,,44181,45285,86,36881,5,37985,5
86,41635,5,41787,6,152,2013,2014,,,,45285,45437,86,37985,5,38137,6
86,41787,6,42366,6,579,2014,2015,,,,45437,46016,86,38137,6,38716,6
87,41170,3,42366,3,1196,2012,2015,,,,44820,46016,87,37520,3,38716,3
88,39951,5,40682,5,731,2009,2011,,,,43601,44332,88,36301,5,37032,5
88,40682,5,42366,5,1684,2011,2015,,,,44332,46016,88,37032,5,38716,5
89,40783,4,42366,4,1583,2011,2015,,,,44433,46016,89,37133,4,38716,4
91,40174,2,41421,3,1247,2009,2013,,,,43824,45071,91,36524,2,37771,3
92,39951,5,41565,5,1614,2009,2013,,,,43601,45215,92,36301,5,37915,5
92,41565,5,42001,4,436,2013,2014,,,,45215,45651,92,37915,5,38351,4
92,42001,4,42366,4,365,2014,2015,,,,45651,46016,92,38351,4,38716,4
93,41078,4,42001,4,923,2012,2014,,,,44728,45651,93,37428,4,38351,4
93,42001,4,42366,4,365,2014,2015,,,,45651,46016,93,38351,4,38716,4
94,40326,4,42366,4,2040,2010,2015,,,,43976,46016,94,36676,4,38716,4
95,42152,4,42366,4,214,2015,2015,,,,45802,46016,95,38502,4,38716,4
96,40540,3,42366,3,1826,2010,2015,,,,44190,46016,96,36890,3,38716,3
97,40713,5,40814,4,101,2011,2011,,,,44363,44464,97,37063,5,37164,4
97,40814,4,42001,5,1187,2011,2014,,,,44464,45651,97,37164,4,38351,5
97,42001,5,42366,5,365,2014,2015,,,,45651,46016,97,38351,5,38716,5
98,41050,3,42366,3,1316,2012,2015,,,,44700,46016,98,37400,3,38716,3
100,39951,4,40510,4,559,2009,2010,,,,43601,44160,100,36301,4,36860,4
100,40510,4,41635,3,1125,2010,2013,,,,44160,45285,100,36860,4,37985,3
100,41635,3,42366,3,731,2013,2015,,,,45285,46016,100,37985,3,38716,3
101,41270,3,42366,3,1096,2012,2015,,,,44920,46016,101,37620,3,38716,3
105,40174,3,42366,3,2192,2009,2015,,,,43824,46016,105,36524,3,38716,3
106,41179,4,41421,6,242,2012,2013,,,,44829,45071,106,37529,4,37771,6
106,41421,6,41605,5,184,2013,2013,,,,45071,45255,106,37771,6,37955,5
106,41605,5,42366,5,761,2013,2015,,,,45255,46016,106,37955,5,38716,5
107,39951,4,40682,4,731,2009,2011,,,,43601,44332,107,36301,4,37032,4
107,40682,4,42366,4,1684,2011,2015,,,,44332,46016,107,37032,4,38716,4
108,40174,3,41635,3,1461,2009,2013,,,,43824,45285,108,36524,3,37985,3
108,41635,3,42366,3,731,2013,2015,,,,45285,46016,108,37985,3,38716,3
110,40326,3,42366,3,2040,2010,2015,,,,43976,46016,110,36676,3,38716,3
111,40905,2,42366,2,1461,2011,2015,,,,44555,46016,111,37255,2,38716,2
111,40905,2,42366,2,1461,2011,2015,,,,44555,46016,111,37255,2,38716,2
112,42001,5,42366,5,365,2014,2015,,,,45651,46016,112,38351,5,38716,5
113,39960,4,40682,4,722,2009,2011,,,,43610,44332,113,36310,4,37032,4
113,40682,4,42366,4,1684,2011,2015,,,,44332,46016,113,37032,4,38716,4
114,41270,3,42366,3,1096,2012,2015,,,,44920,46016,114,37620,3,38716,3
115,39991,3,41635,3,1644,2009,2013,,,,43641,45285,115,36341,3,37985,3
115,41635,3,42366,3,731,2013,2015,,,,45285,46016,115,37985,3,38716,3
116,39960,4,40325,3,365,2009,2010,,,,43610,43975,116,36310,4,36675,3
116,40325,3,41787,3,1462,2010,2014,,,,43975,45437,116,36675,3,38137,3
116,41787,3,42366,3,579,2014,2015,,,,45437,46016,116,38137,3,38716,3
117,39960,4,40378,3,418,2009,2010,,,,43610,44028,117,36310,4,36728,3
117,40378,3,42366,3,1988,2010,2015,,,,44028,46016,117,36728,3,38716,3
118,42143,3,42366,4,223,2015,2015,,,,45793,46016,118,38493,3,38716,4
118,42143,4,42366,4,223,2015,2015,,,,45793,46016,118,38493,4,38716,4
120,39951,4,40174,4,223,2009,2009,,,,43601,43824,120,36301,4,36524,4
120,40174,4,42366,4,2192,2009,2015,,,,43824,46016,120,36524,4,38716,4
121,41901,4,42366,4,465,2014,2015,,,,45551,46016,121,38251,4,38716,4
122,40355,3,41565,2,1210,2010,2013,,,,44005,45215,122,36705,3,37915,2
122,41565,2,42366,2,801,2013,2015,,,,45215,46016,122,37915,2,38716,2
123,41421,3,41778,3,357,2013,2014,,,,45071,45428,123,37771,3,38128,3
123,41778,3,42366,3,588,2014,2015,,,,45428,46016,123,38128,3,38716,3
124,40074,3,42366,3,2292,2009,2015,,,,43724,46016,124,36424,3,38716,3
125,40174,2,42366,2,2192,2009,2015,,,,43824,46016,125,36524,2,38716,2
126,41056,5,41848,4,792,2012,2014,,,,44706,45498,126,37406,5,38198,4
126,41848,4,42366,4,518,2014,2015,,,,45498,46016,126,38198,4,38716,4
127,40113,5,40174,5,61,2009,2009,,,,43763,43824,127,36463,5,36524,5
127,40174,5,42366,6,2192,2009,2015,,,,43824,46016,127,36524,5,38716,6
127,40174,6,41848,5,1674,2009,2014,,,,43824,45498,127,36524,6,38198,5
127,41848,5,42366,5,518,2014,2015,,,,45498,46016,127,38198,5,38716,5
128,40144,2,41270,3,1126,2009,2012,,,,43794,44920,128,36494,2,37620,3
129,41778,3,42366,3,588,2014,2015,,,,45428,46016,129,38128,3,38716,3
132,40540,3,40682,3,142,2010,2011,,,,44190,44332,132,36890,3,37032,3
132,40682,3,42366,3,1684,2011,2015,,,,44332,46016,132,37032,3,38716,3
134,39958,2,40318,2,360,2009,2010,,,,43608,43968,134,36308,2,36668,2
134,40318,2,41786,2,1468,2010,2014,,,,43968,45436,134,36668,2,38136,2
134,41786,2,42366,2,580,2014,2015,,,,45436,46016,134,38136,2,38716,2
135,40326,3,40713,3,387,2010,2011,,,,43976,44363,135,36676,3,37063,3
135,40713,3,42366,3,1653,2011,2015,,,,44363,46016,135,37063,3,38716,3
137,40685,4,42366,4,1681,2011,2015,,,,44335,46016,137,37035,4,38716,4
139,40174,3,40691,4,517,2009,2011,,,,43824,44341,139,36524,3,37041,4
139,40691,4,42366,4,1675,2011,2015,,,,44341,46016,139,37041,4,38716,4
140,42152,3,42366,3,214,2015,2015,,,,45802,46016,140,38502,3,38716,3
142,40905,5,41787,4,882,2011,2014,,,,44555,45437,142,37255,5,38137,4
142,41787,4,42366,4,579,2014,2015,,,,45437,46016,142,38137,4,38716,4
143,40174,4,40326,3,152,2009,2010,,,,43824,43976,143,36524,4,36676,3
143,40326,3,41139,3,813,2010,2012,,,,43976,44789,143,36676,3,37489,3
143,41139,3,42366,3,1227,2012,2015,,,,44789,46016,143,37489,3,38716,3
144,41412,4,42366,4,954,2013,2015,,,,45062,46016,144,37762,4,38716,4
145,40326,3,42366,3,2040,2010,2015,,,,43976,46016,145,36676,3,38716,3
146,40722,1,42366,1,1644,2011,2015,,,,44372,46016,146,37072,1,38716,1
148,40317,3,42366,3,2049,2010,2015,,,,43967,46016,148,36667,3,38716,3
149,41209,4,41635,3,426,2012,2013,,,,44859,45285,149,37559,4,37985,3
149,41635,3,42366,3,731,2013,2015,,,,45285,46016,149,37985,3,38716,3
150,40687,2,40722,2,35,2011,2011,,,,44337,44372,150,37037,2,37072,2
150,40722,2,41785,2,1063,2011,2014,,,,44372,45435,150,37072,2,38135,2
150,41785,2,42366,2,581,2014,2015,,,,45435,46016,150,38135,2,38716,2
152,41421,2,42366,2,945,2013,2015,,,,45071,46016,152,37771,2,38716,2
153,40510,4,42366,4,1856,2010,2015,,,,44160,46016,153,36860,4,38716,4
154,41056,1,42366,1,1310,2012,2015,,,,44706,46016,154,37406,1,38716,1
155,41513,4,42366,4,853,2013,2015,,,,45163,46016,155,37863,4,38716,4
156,40174,6,40317,7,143,2009,2010,,,,43824,43967,156,36524,6,36667,7
156,40317,7,40326,6,9,2010,2010,,,,43967,43976,156,36667,7,36676,6
156,40326,6,41421,7,1095,2010,2013,,,,43976,45071,156,36676,6,37771,7
156,41421,7,41787,6,366,2013,2014,,,,45071,45437,156,37771,7,38137,6
156,41787,6,41971,6,184,2014,2014,,,,45437,45621,156,38137,6,38321,6
156,41971,6,42366,6,395,2014,2015,,,,45621,46016,156,38321,6,38716,6
157,41139,3,41231,3,92,2012,2012,,,,44789,44881,157,37489,3,37581,3
157,41231,3,41635,3,404,2012,2013,,,,44881,45285,157,37581,3,37985,3
160,40682,2,41635,3,953,2011,2013,,,,44332,45285,160,37032,2,37985,3
160,41635,3,42366,3,731,2013,2015,,,,45285,46016,160,37985,3,38716,3
161,39958,6,40378,6,420,2009,2010,,,,43608,44028,161,36308,6,36728,6
161,40378,6,41047,7,669,2010,2012,,,,44028,44697,161,36728,6,37397,7
161,41270,6,42366,7,1096,2012,2015,,,,44920,46016,161,37620,6,38716,7
161,41270,7,42366,7,1096,2012,2015,,,,44920,46016,161,37620,7,38716,7
162,39960,6,40107,6,147,2009,2009,,,,43610,43757,162,36310,6,36457,6
162,40107,6,42366,6,2259,2009,2015,,,,43757,46016,162,36457,6,38716,6
163,41270,3,42366,3,1096,2012,2015,,,,44920,46016,163,37620,3,38716,3
165,41056,6,41513,7,457,2012,2013,,,,44706,45163,165,37406,6,37863,7
165,41513,7,41787,6,274,2013,2014,,,,45163,45437,165,37863,7,38137,6
165,41787,6,42366,6,579,2014,2015,,,,45437,46016,165,38137,6,38716,6
166,40449,3,41270,3,821,2010,2012,,,,44099,44920,166,36799,3,37620,3
166,41270,3,42366,4,1096,2012,2015,,,,44920,46016,166,37620,3,38716,4
166,41270,4,42366,5,1096,2012,2015,,,,44920,46016,166,37620,4,38716,5
166,41270,5,41635,5,365,2012,2013,,,,44920,45285,166,37620,5,37985,5
166,41635,5,42366,5,731,2013,2015,,,,45285,46016,166,37985,5,38716,5
167,39951,4,41818,3,1867,2009,2014,,,,43601,45468,167,36301,4,38168,3
167,41818,3,42366,3,548,2014,2015,,,,45468,46016,167,38168,3,38716,3
168,41870,4,42366,4,496,2014,2015,,,,45520,46016,168,38220,4,38716,4
169,40326,2,40449,2,123,2010,2010,,,,43976,44099,169,36676,2,36799,2
169,40449,2,42366,2,1917,2010,2015,,,,44099,46016,169,36799,2,38716,2
170,40691,3,40905,3,214,2011,2011,,,,44341,44555,170,37041,3,37255,3
170,40905,3,41443,4,538,2011,2013,,,,44555,45093,170,37255,3,37793,4
170,41443,4,42001,5,558,2013,2014,,,,45093,45651,170,37793,4,38351,5
171,40326,3,42001,3,1675,2010,2014,,,,43976,45651,171,36676,3,38351,3
171,42001,3,42366,3,365,2014,2015,,,,45651,46016,171,38351,3,38716,3
172,41565,3,42366,3,801,2013,2015,,,,45215,46016,172,37915,3,38716,3
173,40905,2,41056,3,151,2011,2012,,,,44555,44706,173,37255,2,37406,3
173,41818,2,42366,2,548,2014,2015,,,,45468,46016,173,38168,2,38716,2
175,42001,4,42366,4,365,2014,2015,,,,45651,46016,175,38351,4,38716,4
176,39991,5,40317,5,326,2009,2010,,,,43641,43967,176,36341,5,36667,5
176,40317,5,41056,4,739,2010,2012,,,,43967,44706,176,36667,5,37406,4
177,42143,2,42152,2,9,2015,2015,,,,45793,45802,177,38493,2,38502,2
177,42152,2,42366,2,214,2015,2015,,,,45802,46016,177,38502,2,38716,2
180,42147,2,42366,2,219,2015,2015,,,,45797,46016,180,38497,2,38716,2
181,41848,4,42143,3,295,2014,2015,,,,45498,45793,181,38198,4,38493,3
181,42143,3,42366,3,223,2015,2015,,,,45793,46016,181,38493,3,38716,3
182,40682,3,41635,3,953,2011,2013,,,,44332,45285,182,37032,3,37985,3
182,41635,3,42366,3,731,2013,2015,,,,45285,46016,182,37985,3,38716,3
184,41421,3,42366,3,945,2013,2015,,,,45071,46016,184,37771,3,38716,3
185,41839,3,42366,3,527,2014,2015,,,,45489,46016,185,38189,3,38716,3
187,40412,2,41574,2,1162,2010,2013,,,,44062,45224,187,36762,2,37924,2
187,41574,2,42366,2,792,2013,2015,,,,45224,46016,187,37924,2,38716,2
188,40540,3,42366,3,1826,2010,2015,,,,44190,46016,188,36890,3,38716,3
189,41117,4,42366,4,1249,2012,2015,,,,44767,46016,189,37467,4,38716,4
191,41056,3,41209,4,153,2012,2012,,,,44706,44859,191,37406,3,37559,4
191,41209,4,41270,4,61,2012,2012,,,,44859,44920,191,37559,4,37620,4
191,41270,4,42366,5,1096,2012,2015,,,,44920,46016,191,37620,4,38716,5
191,41270,5,42366,5,1096,2012,2015,,,,44920,46016,191,37620,5,38716,5
192,40357,3,40682,3,325,2010,2011,,,,44007,44332,192,36707,3,37032,3
192,40682,3,42366,3,1684,2011,2015,,,,44332,46016,192,37032,3,38716,3
194,41209,3,41412,3,203,2012,2013,,,,44859,45062,194,37559,3,37762,3
194,41412,3,42366,3,954,2013,2015,,,,45062,46016,194,37762,3,38716,3
195,40540,4,41209,4,669,2010,2012,,,,44190,44859,195,36890,4,37559,4
195,41209,4,42152,4,943,2012,2015,,,,44859,45802,195,37559,4,38502,4
195,42152,4,42366,4,214,2015,2015,,,,45802,46016,195,38502,4,38716,4
197,41635,2,42366,2,731,2013,2015,,,,45285,46016,197,37985,2,38716,2
198,40173,4,41421,5,1248,2009,2013,,,,43823,45071,198,36523,4,37771,5
198,41421,5,42366,5,945,2013,2015,,,,45071,46016,198,37771,5,38716,5
200,39960,4,42366,4,2406,2009,2015,,,,43610,46016,200,36310,4,38716,4
201,42001,4,42366,4,365,2014,2015,,,,45651,46016,201,38351,4,38716,4
202,39982,5,40074,5,92,2009,2009,,,,43632,43724,202,36332,5,36424,5
202,40074,5,40905,5,831,2009,2011,,,,43724,44555,202,36424,5,37255,5
202,40905,5,42366,5,1461,2011,2015,,,,44555,46016,202,37255,5,38716,5
203,41421,6,41787,6,366,2013,2014,,,,45071,45437,203,37771,6,38137,6
203,41787,6,42366,6,579,2014,2015,,,,45437,46016,203,38137,6,38716,6
204,40774,3,41056,3,282,2011,2012,,,,44424,44706,204,37124,3,37406,3
204,41056,3,42366,4,1310,2012,2015,,,,44706,46016,204,37406,3,38716,4
204,41056,4,41139,6,83,2012,2012,,,,44706,44789,204,37406,4,37489,6
204,41139,6,41170,5,31,2012,2012,,,,44789,44820,204,37489,6,37520,5
204,41170,5,41270,4,100,2012,2012,,,,44820,44920,204,37520,5,37620,4
206,40348,4,40752,4,404,2010,2011,,,,43998,44402,206,36698,4,37102,4
206,40752,4,41940,5,1188,2011,2014,,,,44402,45590,206,37102,4,38290,5
206,41940,5,42366,5,426,2014,2015,,,,45590,46016,206,38290,5,38716,5
208,41078,6,41179,6,101,2012,2012,,,,44728,44829,208,37428,6,37529,6
208,41179,6,41270,5,91,2012,2012,,,,44829,44920,208,37529,6,37620,5
208,41270,5,42366,5,1096,2012,2015,,,,44920,46016,208,37620,5,38716,5
211,40018,2,40682,2,664,2009,2011,,,,43668,44332,211,36368,2,37032,2
211,40682,2,41635,2,953,2011,2013,,,,44332,45285,211,37032,2,37985,2
211,41635,2,42366,2,731,2013,2015,,,,45285,46016,211,37985,2,38716,2
212,42001,4,42366,4,365,2014,2015,,,,45651,46016,212,38351,4,38716,4
213,41056,4,42366,4,1310,2012,2015,,,,44706,46016,213,37406,4,38716,4
214,39960,4,41209,4,1249,2009,2012,,,,43610,44859,214,36310,4,37559,4
214,41209,4,42366,4,1157,2012,2015,,,,44859,46016,214,37559,4,38716,4
215,41047,3,42366,3,1319,2012,2015,,,,44697,46016,215,37397,3,38716,3
216,39951,2,41270,1,1319,2009,2012,,,,43601,44920,216,36301,2,37620,1
216,41270,1,42366,1,1096,2012,2015,,,,44920,46016,216,37620,1,38716,1
219,41605,3,42366,3,761,2013,2015,,,,45255,46016,219,37955,3,38716,3
220,40418,4,42366,4,1948,2010,2015,,,,44068,46016,220,36768,4,38716,4
221,40174,4,42366,4,2192,2009,2015,,,,43824,46016,221,36524,4,38716,4
222,40440,3,41443,3,1003,2010,2013,,,,44090,45093,222,36790,3,37793,3
222,41443,3,42366,3,923,2013,2015,,,,45093,46016,222,37793,3,38716,3
223,41108,4,42366,4,1258,2012,2015,,,,44758,46016,223,37458,4,38716,4
224,40479,5,40905,5,426,2010,2011,,,,44129,44555,224,36829,5,37255,5
224,40905,5,41544,6,639,2011,2013,,,,44555,45194,224,37255,5,37894,6
224,41544,6,41818,6,274,2013,2014,,,,45194,45468,224,37894,6,38168,6
224,41818,6,42366,6,548,2014,2015,,,,45468,46016,224,38168,6,38716,6
226,39960,4,42001,3,2041,2009,2014,,,,43610,45651,226,36310,4,38351,3
227,41635,3,42366,3,731,2013,2015,,,,45285,46016,227,37985,3,38716,3
229,40540,3,40682,3,142,2010,2011,,,,44190,44332,229,36890,3,37032,3
229,40682,3,42366,3,1684,2011,2015,,,,44332,46016,229,37032,3,38716,3
230,41240,4,41270,4,30,2012,2012,,,,44890,44920,230,37590,4,37620,4
230,41270,4,41992,3,722,2012,2014,,,,44920,45642,230,37620,4,38342,3
230,41992,3,42366,3,374,2014,2015,,,,45642,46016,230,38342,3,38716,3
231,40905,3,41421,4,516,2011,2013,,,,44555,45071,231,37255,3,37771,4
231,41421,4,41778,4,357,2013,2014,,,,45071,45428,231,37771,4,38128,4
231,41778,4,42366,4,588,2014,2015,,,,45428,46016,231,38128,4,38716,4
231,42366,4,42366,4,0,2015,2015,,,,46016,46016,231,38716,4,38716,4
232,40174,3,42366,3,2192,2009,2015,,,,43824,46016,232,36524,3,38716,3
233,40691,4,42366,4,1675,2011,2015,,,,44341,46016,233,37041,4,38716,4
234,40479,2,42366,2,1887,2010,2015,,,,44129,46016,234,36829,2,38716,2
235,40174,4,42366,4,2192,2009,2015,,,,43824,46016,235,36524,4,38716,4
237,40540,3,42366,3,1826,2010,2015,,,,44190,46016,237,36890,3,38716,3
238,40326,3,40682,3,356,2010,2011,,,,43976,44332,238,36676,3,37032,3
238,40682,3,40905,3,223,2011,2011,,,,44332,44555,238,37032,3,37255,3
238,40905,3,42366,3,1461,2011,2015,,,,44555,46016,238,37255,3,38716,3
239,40682,3,41270,3,588,2011,2012,,,,44332,44920,239,37032,3,37620,3
239,41270,3,42366,3,1096,2012,2015,,,,44920,46016,239,37620,3,38716,3
241,39951,5,40379,4,428,2009,2010,,,,43601,44029,241,36301,5,36729,4
241,40379,4,40835,4,456,2010,2011,,,,44029,44485,241,36729,4,37185,4
241,40835,4,41270,3,435,2011,2012,,,,44485,44920,241,37185,4,37620,3
241,41270,3,42366,3,1096,2012,2015,,,,44920,46016,241,37620,3,38716,3
242,41170,5,42001,3,831,2012,2014,,,,44820,45651,242,37520,5,38351,3
242,42001,3,42366,3,365,2014,2015,,,,45651,46016,242,38351,3,38716,3
243,40317,3,42001,3,1684,2010,2014,,,,43967,45651,243,36667,3,38351,3
243,42001,3,42366,3,365,2014,2015,,,,45651,46016,243,38351,3,38716,3
244,39951,4,41931,3,1980,2009,2014,,,,43601,45581,244,36301,4,38281,3
244,41931,3,42366,3,435,2014,2015,,,,45581,46016,244,38281,3,38716,3
246,40326,3,40774,4,448,2010,2011,,,,43976,44424,246,36676,3,37124,4
246,40774,4,41117,4,343,2011,2012,,,,44424,44767,246,37124,4,37467,4
247,39951,3,40774,4,823,2009,2011,,,,43601,44424,247,36301,3,37124,4
247,40774,4,40905,3,131,2011,2011,,,,44424,44555,247,37124,4,37255,3
247,40905,3,41051,4,146,2011,2012,,,,44555,44701,247,37255,3,37401,4
247,41051,4,42366,4,1315,2012,2015,,,,44701,46016,247,37401,4,38716,4
248,40682,4,42366,5,1684,2011,2015,,,,44332,46016,248,37032,4,38716,5
248,40682,5,42366,5,1684,2011,2015,,,,44332,46016,248,37032,5,38716,5
248,40682,5,41270,5,588,2011,2012,,,,44332,44920,248,37032,5,37620,5
248,41270,5,41412,6,142,2012,2013,,,,44920,45062,248,37620,5,37762,6
248,41412,6,42183,5,771,2013,2015,,,,45062,45833,248,37762,6,38533,5
248,42183,5,42366,5,183,2015,2015,,,,45833,46016,248,38533,5,38716,5
249,40866,5,41179,6,313,2011,2012,,,,44516,44829,249,37216,5,37529,6
249,41179,6,41421,6,242,2012,2013,,,,44829,45071,249,37529,6,37771,6
249,41421,6,42366,6,945,2013,2015,,,,45071,46016,249,37771,6,38716,6
250,40905,4,42366,4,1461,2011,2015,,,,44555,46016,250,37255,4,38716,4
251,39951,6,40531,6,580,2009,2010,,,,43601,44181,251,36301,6,36881,6
251,40531,6,40691,6,160,2010,2011,,,,44181,44341,251,36881,6,37041,6
251,40691,6,41940,6,1249,2011,2014,,,,44341,45590,251,37041,6,38290,6
251,41940,6,42001,6,61,2014,2014,,,,45590,45651,251,38290,6,38351,6
251,42001,6,42366,6,365,2014,2015,,,,45651,46016,251,38351,6,38716,6
252,40540,4,41240,4,700,2010,2012,,,,44190,44890,252,36890,4,37590,4
252,41240,4,42366,4,1126,2012,2015,,,,44890,46016,252,37590,4,38716,4
253,40317,5,42366,5,2049,2010,2015,,,,43967,46016,253,36667,5,38716,5
254,40774,6,41421,6,647,2011,2013,,,,44424,45071,254,37124,6,37771,6
254,41421,6,42366,6,945,2013,2015,,,,45071,46016,254,37771,6,38716,6
255,40691,5,41605,6,914,2011,2013,,,,44341,45255,255,37041,5,37955,6
255,41605,6,42366,6,761,2013,2015,,,,45255,46016,255,37955,6,38716,6
256,39951,3,40691,4,740,2009,2011,,,,43601,44341,256,36301,3,37041,4
256,40691,4,42366,4,1675,2011,2015,,,,44341,46016,256,37041,4,38716,4
257,40835,4,41635,4,800,2011,2013,,,,44485,45285,257,37185,4,37985,4
257,41635,4,41879,4,244,2013,2014,,,,45285,45529,257,37985,4,38229,4
257,41879,4,42305,5,426,2014,2015,,,,45529,45955,257,38229,4,38655,5
257,42305,5,42366,5,61,2015,2015,,,,45955,46016,257,38655,5,38716,5
258,40752,3,42366,3,1614,2011,2015,,,,44402,46016,258,37102,3,38716,3
259,40174,5,40540,5,366,2009,2010,,,,43824,44190,259,36524,5,36890,5
259,40540,5,40905,6,365,2010,2011,,,,44190,44555,259,36890,5,37255,6
259,40905,6,41780,5,875,2011,2014,,,,44555,45430,259,37255,6,38130,5
259,41780,5,42366,5,586,2014,2015,,,,45430,46016,259,38130,5,38716,5
261,41056,3,41421,4,365,2012,2013,,,,44706,45071,261,37406,3,37771,4
261,41421,4,41635,4,214,2013,2013,,,,45071,45285,261,37771,4,37985,4
261,41635,4,42366,4,731,2013,2015,,,,45285,46016,261,37985,4,38716,4
262,40479,2,41270,1,791,2010,2012,,,,44129,44920,262,36829,2,37620,1
262,41270,1,42366,1,1096,2012,2015,,,,44920,46016,262,37620,1,38716,1
263,41047,5,41240,6,193,2012,2012,,,,44697,44890,263,37397,5,37590,6
263,41240,6,42366,6,1126,2012,2015,,,,44890,46016,263,37590,6,38716,6
264,40317,3,40713,4,396,2010,2011,,,,43967,44363,264,36667,3,37063,4
264,40713,4,42305,5,1592,2011,2015,,,,44363,45955,264,37063,4,38655,5
264,42305,5,42366,5,61,2015,2015,,,,45955,46016,264,38655,5,38716,5
265,40317,8,42366,8,2049,2010,2015,,,,43967,46016,265,36667,8,38716,8
266,40317,4,40721,4,404,2010,2011,,,,43967,44371,266,36667,4,37071,4
266,40721,4,41087,3,366,2011,2012,,,,44371,44737,266,37071,4,37437,3
266,41087,3,42366,3,1279,2012,2015,,,,44737,46016,266,37437,3,38716,3
267,41787,3,42366,3,579,2014,2015,,,,45437,46016,267,38137,3,38716,3
268,40020,6,40722,7,702,2009,2011,,,,43670,44372,268,36370,6,37072,7
269,40317,4,41143,6,826,2010,2012,,,,43967,44793,269,36667,4,37493,6
269,41143,6,41170,5,27,2012,2012,,,,44793,44820,269,37493,6,37520,5
269,41170,5,41421,6,251,2012,2013,,,,44820,45071,269,37520,5,37771,6
269,41421,6,42143,6,722,2013,2015,,,,45071,45793,269,37771,6,38493,6
269,42143,6,42366,6,223,2015,2015,,,,45793,46016,269,38493,6,38716,6
270,41078,5,41635,5,557,2012,2013,,,,44728,45285,270,37428,5,37985,5
270,41635,5,42366,5,731,2013,2015,,,,45285,46016,270,37985,5,38716,5
271,40540,3,40752,2,212,2010,2011,,,,44190,44402,271,36890,3,37102,2
271,40752,2,42366,2,1614,2011,2015,,,,44402,46016,271,37102,2,38716,2
272,40682,3,41047,4,365,2011,2012,,,,44332,44697,272,37032,3,37397,4
272,41047,4,42366,4,1319,2012,2015,,,,44697,46016,272,37397,4,38716,4
273,40691,4,41412,5,721,2011,2013,,,,44341,45062,273,37041,4,37762,5
273,41412,5,41421,4,9,2013,2013,,,,45062,45071,273,37762,5,37771,4
273,41421,4,41778,5,357,2013,2014,,,,45071,45428,273,37771,4,38128,5
273,41778,5,42366,5,588,2014,2015,,,,45428,46016,273,38128,5,38716,5
274,40814,3,42366,3,1552,2011,2015,,,,44464,46016,274,37164,3,38716,3
275,39991,2,42366,2,2375,2009,2015,,,,43641,46016,275,36341,2,38716,2
276,39960,2,42366,2,2406,2009,2015,,,,43610,46016,276,36310,2,38716,2
277,42148,2,42366,2,218,2015,2015,,,,45798,46016,277,38498,2,38716,2
279,40418,5,40682,4,264,2010,2011,,,,44068,44332,279,36768,5,37032,4
280,40835,4,41056,4,221,2011,2012,,,,44485,44706,280,37185,4,37406,4
280,41056,4,41544,4,488,2012,2013,,,,44706,45194,280,37406,4,37894,4
280,41544,4,41635,5,91,2013,2013,,,,45194,45285,280,37894,4,37985,5
280,41635,5,41783,6,148,2013,2014,,,,45285,45433,280,37985,5,38133,6
280,41783,6,42366,6,583,2014,2015,,,,45433,46016,280,38133,6,38716,6
281,39951,5,40540,4,589,2009,2010,,,,43601,44190,281,36301,5,36890,4
281,40540,4,40774,4,234,2010,2011,,,,44190,44424,281,36890,4,37124,4
282,40905,3,42366,3,1461,2011,2015,,,,44555,46016,282,37255,3,38716,3
283,40540,3,40682,4,142,2010,2011,,,,44190,44332,283,36890,3,37032,4
283,40682,4,41056,4,374,2011,2012,,,,44332,44706,283,37032,4,37406,4
283,41056,4,41270,5,214,2012,2012,,,,44706,44920,283,37406,4,37620,5
283,41270,5,41412,6,142,2012,2013,,,,44920,45062,283,37620,5,37762,6
283,41412,6,42143,6,731,2013,2015,,,,45062,45793,283,37762,6,38493,6
283,42143,6,42366,6,223,2015,2015,,,,45793,46016,283,38493,6,38716,6
285,40174,6,42366,6,2192,2009,2015,,,,43824,46016,285,36524,6,38716,6
286,40774,3,42366,3,1592,2011,2015,,,,44424,46016,286,37124,3,38716,3
287,40682,3,41047,4,365,2011,2012,,,,44332,44697,287,37032,3,37397,4
287,41047,4,42366,4,1319,2012,2015,,,,44697,46016,287,37397,4,38716,4
288,40682,3,42366,3,1684,2011,2015,,,,44332,46016,288,37032,3,38716,3
289,41240,3,42366,3,1126,2012,2015,,,,44890,46016,289,37590,3,38716,3
290,41596,4,42366,4,770,2013,2015,,,,45246,46016,290,37946,4,38716,4
291,40905,1,42366,1,1461,2011,2015,,,,44555,46016,291,37255,1,38716,1
292,40113,4,40814,4,701,2009,2011,,,,43763,44464,292,36463,4,37164,4
293,39982,4,41209,4,1227,2009,2012,,,,43632,44859,293,36332,4,37559,4
293,41209,4,41635,4,426,2012,2013,,,,44859,45285,293,37559,4,37985,4
293,41635,4,41779,5,144,2013,2014,,,,45285,45429,293,37985,4,38129,5
293,41779,5,42366,5,587,2014,2015,,,,45429,46016,293,38129,5,38716,5
294,41139,5,42366,7,1227,2012,2015,,,,44789,46016,294,37489,5,38716,7
294,41139,7,41170,5,31,2012,2012,,,,44789,44820,294,37489,7,37520,5
295,40691,6,40743,7,52,2011,2011,,,,44341,44393,295,37041,6,37093,7
295,40743,7,42366,8,1623,2011,2015,,,,44393,46016,295,37093,7,38716,8
295,40743,8,41635,7,892,2011,2013,,,,44393,45285,295,37093,8,37985,7
295,41635,7,41778,7,143,2013,2014,,,,45285,45428,295,37985,7,38128,7
295,41778,7,42366,7,588,2014,2015,,,,45428,46016,295,38128,7,38716,7
296,40905,6,41056,6,151,2011,2012,,,,44555,44706,296,37255,6,37406,6
296,41056,6,41418,7,362,2012,2013,,,,44706,45068,296,37406,6,37768,7
296,41418,7,42366,7,948,2013,2015,,,,45068,46016,296,37768,7,38716,7
300,42152,4,42366,4,214,2015,2015,,,,45802,46016,300,38502,4,38716,4
301,40875,4,41270,4,395,2011,2012,,,,44525,44920,301,37225,4,37620,4
301,41270,4,41452,4,182,2012,2013,,,,44920,45102,301,37620,4,37802,4
301,41452,4,42366,4,914,2013,2015,,,,45102,46016,301,37802,4,38716,4
303,41565,5,41901,5,336,2013,2014,,,,45215,45551,303,37915,5,38251,5
303,41901,5,42366,5,465,2014,2015,,,,45551,46016,303,38251,5,38716,5
304,40875,2,40905,1,30,2011,2011,,,,44525,44555,304,37225,2,37255,1
304,40905,1,42152,2,1247,2011,2015,,,,44555,45802,304,37255,1,38502,2
304,42152,2,42366,2,214,2015,2015,,,,45802,46016,304,38502,2,38716,2
304,42152,2,42366,2,214,2015,2015,,,,45802,46016,304,38502,2,38716,2
305,40722,4,40783,4,61,2011,2011,,,,44372,44433,305,37072,4,37133,4
305,40783,4,40905,5,122,2011,2011,,,,44433,44555,305,37133,4,37255,5
305,40905,5,41051,5,146,2011,2012,,,,44555,44701,305,37255,5,37401,5
305,41051,5,42366,5,1315,2012,2015,,,,44701,46016,305,37401,5,38716,5
306,39960,4,42366,4,2406,2009,2015,,,,43610,46016,306,36310,4,38716,4
307,41421,3,42366,3,945,2013,2015,,,,45071,46016,307,37771,3,38716,3
308,42152,2,42366,2,214,2015,2015,,,,45802,46016,308,38502,2,38716,2
308,42152,2,42366,2,214,2015,2015,,,,45802,46016,308,38502,2,38716,2
312,40021,6,42366,6,2345,2009,2015,,,,43671,46016,312,36371,6,38716,6
313,41108,2,41421,3,313,2012,2013,,,,44758,45071,313,37458,2,37771,3
313,41421,3,42366,3,945,2013,2015,,,,45071,46016,313,37771,3,38716,3
314,40107,7,42366,7,2259,2009,2015,,,,43757,46016,314,36457,7,38716,7
315,42143,5,42366,5,223,2015,2015,,,,45793,46016,315,38493,5,38716,5
316,41962,4,42366,4,404,2014,2015,,,,45612,46016,316,38312,4,38716,4
317,40691,8,40714,6,23,2011,2011,,,,44341,44364,317,37041,8,37064,6
317,40714,6,40905,7,191,2011,2011,,,,44364,44555,317,37064,6,37255,7
317,40905,7,42366,7,1461,2011,2015,,,,44555,46016,317,37255,7,38716,7
318,40540,5,42001,4,1461,2010,2014,,,,44190,45651,318,36890,5,38351,4
318,42001,4,42366,4,365,2014,2015,,,,45651,46016,318,38351,4,38716,4
319,41513,4,42366,4,853,2013,2015,,,,45163,46016,319,37863,4,38716,4
320,40021,7,40174,7,153,2009,2009,,,,43671,43824,320,36371,7,36524,7
322,39951,3,40752,4,801,2009,2011,,,,43601,44402,322,36301,3,37102,4
322,40752,4,41476,4,724,2011,2013,,,,44402,45126,322,37102,4,37826,4
322,41476,4,42366,4,890,2013,2015,,,,45126,46016,322,37826,4,38716,4
323,40144,3,40326,3,182,2009,2010,,,,43794,43976,323,36494,3,36676,3
323,40326,3,40691,3,365,2010,2011,,,,43976,44341,323,36676,3,37041,3
323,40691,3,42001,5,1310,2011,2014,,,,44341,45651,323,37041,3,38351,5
323,42001,5,42366,5,365,2014,2015,,,,45651,46016,323,38351,5,38716,5
324,41787,3,42366,3,579,2014,2015,,,,45437,46016,324,38137,3,38716,3
325,40113,6,40317,6,204,2009,2010,,,,43763,43967,325,36463,6,36667,6
325,40317,6,40326,6,9,2010,2010,,,,43967,43976,325,36667,6,36676,6
325,40326,6,40682,7,356,2010,2011,,,,43976,44332,325,36676,6,37032,7
325,40682,7,40722,7,40,2011,2011,,,,44332,44372,325,37032,7,37072,7
326,41839,3,42366,3,527,2014,2015,,,,45489,46016,326,38189,3,38716,3
328,39960,6,40317,5,357,2009,2010,,,,43610,43967,328,36310,6,36667,5
328,40317,5,41870,5,1553,2010,2014,,,,43967,45520,328,36667,5,38220,5
328,41870,5,42366,5,496,2014,2015,,,,45520,46016,328,38220,5,38716,5
329,40875,4,40905,5,30,2011,2011,,,,44525,44555,329,37225,4,37255,5
329,40905,5,42366,6,1461,2011,2015,,,,44555,46016,329,37255,5,38716,6
329,40905,6,41078,6,173,2011,2012,,,,44555,44728,329,37255,6,37428,6
329,41078,6,41574,7,496,2012,2013,,,,44728,45224,329,37428,6,37924,7
329,41574,7,42366,7,792,2013,2015,,,,45224,46016,329,37924,7,38716,7
330,41443,6,42366,6,923,2013,2015,,,,45093,46016,330,37793,6,38716,6
331,40144,6,40540,7,396,2009,2010,,,,43794,44190,331,36494,6,36890,7
331,40540,7,42366,7,1826,2010,2015,,,,44190,46016,331,36890,7,38716,7
334,39960,6,39982,8,22,2009,2009,,,,43610,43632,334,36310,6,36332,8
334,39982,8,40144,5,162,2009,2009,,,,43632,43794,334,36332,8,36494,5
334,40144,5,40687,5,543,2009,2011,,,,43794,44337,334,36494,5,37037,5
334,40687,5,42366,5,1679,2011,2015,,,,44337,46016,334,37037,5,38716,5
335,40783,4,41635,3,852,2011,2013,,,,44433,45285,335,37133,4,37985,3
335,41635,3,42366,3,731,2013,2015,,,,45285,46016,335,37985,3,38716,3
336,41421,4,42366,4,945,2013,2015,,,,45071,46016,336,37771,4,38716,4
337,41240,4,42366,4,1126,2012,2015,,,,44890,46016,337,37590,4,38716,4
338,40322,3,41931,3,1609,2010,2014,,,,43972,45581,338,36672,3,38281,3
338,41931,3,42366,3,435,2014,2015,,,,45581,46016,338,38281,3,38716,3
339,40021,3,40144,4,123,2009,2009,,,,43671,43794,339,36371,3,36494,4
339,40144,4,40682,4,538,2009,2011,,,,43794,44332,339,36494,4,37032,4
339,40682,4,40905,4,223,2011,2011,,,,44332,44555,339,37032,4,37255,4
339,40905,4,42275,4,1370,2011,2015,,,,44555,45925,339,37255,4,38625,4
339,42275,4,42366,4,91,2015,2015,,,,45925,46016,339,38625,4,38716,4
340,39960,5,41535,6,1575,2009,2013,,,,43610,45185,340,36310,5,37885,6
340,41535,6,42366,6,831,2013,2015,,,,45185,46016,340,37885,6,38716,6
341,41778,2,42366,2,588,2014,2015,,,,45428,46016,341,38128,2,38716,2
342,40174,6,40682,6,508,2009,2011,,,,43824,44332,342,36524,6,37032,6
342,40682,6,40774,7,92,2011,2011,,,,44332,44424,342,37032,6,37124,7
342,40774,7,40805,8,31,2011,2011,,,,44424,44455,342,37124,7,37155,8
342,40805,8,40875,7,70,2011,2011,,,,44455,44525,342,37155,8,37225,7
342,40875,7,40905,6,30,2011,2011,,,,44525,44555,342,37225,7,37255,6
342,40905,6,41635,7,730,2011,2013,,,,44555,45285,342,37255,6,37985,7
342,41635,7,42366,7,731,2013,2015,,,,45285,46016,342,37985,7,38716,7
343,41179,4,41901,3,722,2012,2014,,,,44829,45551,343,37529,4,38251,3
343,41901,3,42366,3,465,2014,2015,,,,45551,46016,343,38251,3,38716,3
344,40691,4,42366,4,1675,2011,2015,,,,44341,46016,344,37041,4,38716,4
345,39960,5,40317,5,357,2009,2010,,,,43610,43967,345,36310,5,36667,5
346,40905,4,41270,5,365,2011,2012,,,,44555,44920,346,37255,4,37620,5
346,41270,5,42366,5,1096,2012,2015,,,,44920,46016,346,37620,5,38716,5
347,42001,4,42366,4,365,2014,2015,,,,45651,46016,347,38351,4,38716,4
348,39951,3,41818,3,1867,2009,2014,,,,43601,45468,348,36301,3,38168,3
348,41818,3,42366,3,548,2014,2015,,,,45468,46016,348,38168,3,38716,3
350,40021,6,40104,5,83,2009,2009,,,,43671,43754,350,36371,6,36454,5
350,40104,5,40905,6,801,2009,2011,,,,43754,44555,350,36454,5,37255,6
350,40905,6,41421,6,516,2011,2013,,,,44555,45071,350,37255,6,37771,6
350,41421,6,41635,6,214,2013,2013,,,,45071,45285,350,37771,6,37985,6
351,40326,4,40540,6,214,2010,2010,,,,43976,44190,351,36676,4,36890,6
351,40540,6,42366,8,1826,2010,2015,,,,44190,46016,351,36890,6,38716,8
352,40691,4,41270,4,579,2011,2012,,,,44341,44920,352,37041,4,37620,4
352,41270,4,42366,4,1096,2012,2015,,,,44920,46016,352,37620,4,38716,4
354,40348,4,40875,4,527,2010,2011,,,,43998,44525,354,36698,4,37225,4
354,40875,4,41818,5,943,2011,2014,,,,44525,45468,354,37225,4,38168,5
354,41818,5,42366,5,548,2014,2015,,,,45468,46016,354,38168,5,38716,5
355,40174,6,40779,8,605,2009,2011,,,,43824,44429,355,36524,6,37129,8
355,40779,8,42366,8,1587,2011,2015,,,,44429,46016,355,37129,8,38716,8
356,41047,3,41635,4,588,2012,2013,,,,44697,45285,356,37397,3,37985,4
356,41635,4,42001,4,366,2013,2014,,,,45285,45651,356,37985,4,38351,4
356,42001,4,42366,4,365,2014,2015,,,,45651,46016,356,38351,4,38716,4
357,40418,2,40540,3,122,2010,2010,,,,44068,44190,357,36768,2,36890,3
357,40540,3,40835,2,295,2010,2011,,,,44190,44485,357,36890,3,37185,2
357,40835,2,42366,2,1531,2011,2015,,,,44485,46016,357,37185,2,38716,2
358,40174,4,40682,4,508,2009,2011,,,,43824,44332,358,36524,4,37032,4
358,41179,4,42366,4,1187,2012,2015,,,,44829,46016,358,37529,4,38716,4
360,40905,2,42366,2,1461,2011,2015,,,,44555,46016,360,37255,2,38716,2
361,41482,4,42366,4,884,2013,2015,,,,45132,46016,361,37832,4,38716,4
362,40378,3,42366,3,1988,2010,2015,,,,44028,46016,362,36728,3,38716,3
364,40691,3,41482,4,791,2011,2013,,,,44341,45132,364,37041,3,37832,4
364,41482,4,42366,4,884,2013,2015,,,,45132,46016,364,37832,4,38716,4
365,41231,2,42366,2,1135,2012,2015,,,,44881,46016,365,37581,2,38716,2
369,41056,1,42366,1,1310,2012,2015,,,,44706,46016,369,37406,1,38716,1
371,40540,1,42366,1,1826,2010,2015,,,,44190,46016,371,36890,1,38716,1
372,39991,3,40378,3,387,2009,2010,,,,43641,44028,372,36341,3,36728,3
372,40378,3,40470,2,92,2010,2010,,,,44028,44120,372,36728,3,36820,2
372,40470,2,40691,2,221,2010,2011,,,,44120,44341,372,36820,2,37041,2
373,39951,3,40326,2,375,2009,2010,,,,43601,43976,373,36301,3,36676,2
373,40326,2,40540,3,214,2010,2010,,,,43976,44190,373,36676,2,36890,3
373,40540,3,40743,2,203,2010,2011,,,,44190,44393,373,36890,3,37093,2
373,40743,2,42366,2,1623,2011,2015,,,,44393,46016,373,37093,2,38716,2
374,40540,2,42366,2,1826,2010,2015,,,,44190,46016,374,36890,2,38716,2
375,41971,2,42366,2,395,2014,2015,,,,45621,46016,375,38321,2,38716,2
376,40074,3,40682,4,608,2009,2011,,,,43724,44332,376,36424,3,37032,4
376,40682,4,41047,4,365,2011,2012,,,,44332,44697,376,37032,4,37397,4
376,41047,4,41635,5,588,2012,2013,,,,44697,45285,376,37397,4,37985,5
376,41635,5,42366,5,731,2013,2015,,,,45285,46016,376,37985,5,38716,5
377,41412,4,42366,4,954,2013,2015,,,,45062,46016,377,37762,4,38716,4
378,41635,4,42366,4,731,2013,2015,,,,45285,46016,378,37985,4,38716,4
379,41602,2,42366,2,764,2013,2015,,,,45252,46016,379,37952,2,38716,2
380,40351,3,42366,3,2015,2010,2015,,,,44001,46016,380,36701,3,38716,3
382,40326,3,40814,2,488,2010,2011,,,,43976,44464,382,36676,3,37164,2
382,40814,2,42366,2,1552,2011,2015,,,,44464,46016,382,37164,2,38716,2
385,42152,5,42366,5,214,2015,2015,,,,45802,46016,385,38502,5,38716,5
386,40174,6,40835,6,661,2009,2011,,,,43824,44485,386,36524,6,37185,6
386,40835,6,41412,6,577,2011,2013,,,,44485,45062,386,37185,6,37762,6
386,41412,6,42001,6,589,2013,2014,,,,45062,45651,386,37762,6,38351,6
386,42001,6,42183,7,182,2014,2015,,,,45651,45833,386,38351,6,38533,7
386,42183,7,42366,7,183,2015,2015,,,,45833,46016,386,38533,7,38716,7
387,40174,3,42366,3,2192,2009,2015,,,,43824,46016,387,36524,3,38716,3
388,41108,3,42366,3,1258,2012,2015,,,,44758,46016,388,37458,3,38716,3
389,39960,3,41056,3,1096,2009,2012,,,,43610,44706,389,36310,3,37406,3
389,41056,3,42366,3,1310,2012,2015,,,,44706,46016,389,37406,3,38716,3
390,39951,2,41201,3,1250,2009,2012,,,,43601,44851,390,36301,2,37551,3
390,41201,3,41635,2,434,2012,2013,,,,44851,45285,390,37551,3,37985,2
390,41635,2,42366,2,731,2013,2015,,,,45285,46016,390,37985,2,38716,2
391,40440,3,41270,2,830,2010,2012,,,,44090,44920,391,36790,3,37620,2
392,40540,3,42366,3,1826,2010,2015,,,,44190,46016,392,36890,3,38716,3
393,40540,6,40905,5,365,2010,2011,,,,44190,44555,393,36890,6,37255,5
393,40905,5,41270,5,365,2011,2012,,,,44555,44920,393,37255,5,37620,5
393,41270,5,41901,5,631,2012,2014,,,,44920,45551,393,37620,5,38251,5
393,41901,5,42366,5,465,2014,2015,,,,45551,46016,393,38251,5,38716,5
394,41839,6,41870,5,31,2014,2014,,,,45489,45520,394,38189,6,38220,5
394,41870,5,42366,5,496,2014,2015,,,,45520,46016,394,38220,5,38716,5
396,40540,4,40905,3,365,2010,2011,,,,44190,44555,396,36890,4,37255,3
396,40905,3,42149,3,1244,2011,2015,,,,44555,45799,396,37255,3,38499,3
396,42149,3,42366,3,217,2015,2015,,,,45799,46016,396,38499,3,38716,3
397,41047,3,42366,3,1319,2012,2015,,,,44697,46016,397,37397,3,38716,3
398,40713,2,42366,2,1653,2011,2015,,,,44363,46016,398,37063,2,38716,2
401,39951,4,41778,3,1827,2009,2014,,,,43601,45428,401,36301,4,38128,3
401,41778,3,41901,3,123,2014,2014,,,,45428,45551,401,38128,3,38251,3
401,41901,3,42366,3,465,2014,2015,,,,45551,46016,401,38251,3,38716,3
403,40113,4,41778,4,1665,2009,2014,,,,43763,45428,403,36463,4,38128,4
403,41778,4,42152,3,374,2014,2015,,,,45428,45802,403,38128,4,38502,3
403,42152,3,42366,3,214,2015,2015,,,,45802,46016,403,38502,3,38716,3
404,40317,2,42366,2,2049,2010,2015,,,,43967,46016,404,36667,2,38716,2
405,40326,2,42366,2,2040,2010,2015,,,,43976,46016,405,36676,2,38716,2
406,39960,7,42366,8,2406,2009,2015,,,,43610,46016,406,36310,7,38716,8
409,41270,3,42001,2,731,2012,2014,,,,44920,45651,409,37620,3,38351,2
409,42001,2,42366,2,365,2014,2015,,,,45651,46016,409,38351,2,38716,2
411,39951,6,40174,6,223,2009,2009,,,,43601,43824,411,36301,6,36524,6
411,40174,6,40905,6,731,2009,2011,,,,43824,44555,411,36524,6,37255,6
412,39954,5,40418,4,464,2009,2010,,,,43604,44068,412,36304,5,36768,4
412,40418,4,41240,4,822,2010,2012,,,,44068,44890,412,36768,4,37590,4
413,39960,3,40540,2,580,2009,2010,,,,43610,44190,413,36310,3,36890,2
413,40540,2,42366,2,1826,2010,2015,,,,44190,46016,413,36890,2,38716,2
414,41412,2,41879,2,467,2013,2014,,,,45062,45529,414,37762,2,38229,2
414,41879,2,42366,2,487,2014,2015,,,,45529,46016,414,38229,2,38716,2
415,40021,2,42366,2,2345,2009,2015,,,,43671,46016,415,36371,2,38716,2
416,40682,3,42366,3,1684,2011,2015,,,,44332,46016,416,37032,3,38716,3
417,40449,3,42366,3,1917,2010,2015,,,,44099,46016,417,36799,3,38716,3
418,40905,2,42366,2,1461,2011,2015,,,,44555,46016,418,37255,2,38716,2
419,40905,2,42366,2,1461,2011,2015,,,,44555,46016,419,37255,2,38716,2
421,40540,4,41148,5,608,2010,2012,,,,44190,44798,421,36890,4,37498,5
421,41148,5,42366,5,1218,2012,2015,,,,44798,46016,421,37498,5,38716,5
422,39982,5,40326,4,344,2009,2010,,,,43632,43976,422,36332,5,36676,4
422,40326,4,40743,4,417,2010,2011,,,,43976,44393,422,36676,4,37093,4
422,40743,4,41054,4,311,2011,2012,,,,44393,44704,422,37093,4,37404,4
422,41054,4,42366,4,1312,2012,2015,,,,44704,46016,422,37404,4,38716,4
423,42001,4,42366,4,365,2014,2015,,,,45651,46016,423,38351,4,38716,4
424,40537,2,41412,3,875,2010,2013,,,,44187,45062,424,36887,2,37762,3
424,41412,3,42366,3,954,2013,2015,,,,45062,46016,424,37762,3,38716,3
425,40326,2,41270,3,944,2010,2012,,,,43976,44920,425,36676,2,37620,3
425,41270,3,41421,3,151,2012,2013,,,,44920,45071,425,37620,3,37771,3
425,41421,3,42366,3,945,2013,2015,,,,45071,46016,425,37771,3,38716,3
426,40905,3,41635,3,730,2011,2013,,,,44555,45285,426,37255,3,37985,3
426,41635,3,42366,3,731,2013,2015,,,,45285,46016,426,37985,3,38716,3
427,40479,3,42366,3,1887,2010,2015,,,,44129,46016,427,36829,3,38716,3
428,40844,3,42366,3,1522,2011,2015,,,,44494,46016,428,37194,3,38716,3
429,41087,4,42366,4,1279,2012,2015,,,,44737,46016,429,37437,4,38716,4
430,40479,2,41078,3,599,2010,2012,,,,44129,44728,430,36829,2,37428,3
430,41078,3,41412,3,334,2012,2013,,,,44728,45062,430,37428,3,37762,3
430,41412,3,42366,3,954,2013,2015,,,,45062,46016,430,37762,3,38716,3
431,40510,2,41056,3,546,2010,2012,,,,44160,44706,431,36860,2,37406,3
431,41056,3,41482,3,426,2012,2013,,,,44706,45132,431,37406,3,37832,3
431,41482,3,42366,3,884,2013,2015,,,,45132,46016,431,37832,3,38716,3
432,40814,3,42366,3,1552,2011,2015,,,,44464,46016,432,37164,3,38716,3
433,40110,5,40540,6,430,2009,2010,,,,43760,44190,433,36460,5,36890,6
433,40540,6,40905,5,365,2010,2011,,,,44190,44555,433,36890,6,37255,5
433,40905,5,41112,5,207,2011,2012,,,,44555,44762,433,37255,5,37462,5
434,41635,3,42366,3,731,2013,2015,,,,45285,46016,434,37985,3,38716,3
435,40682,2,40905,3,223,2011,2011,,,,44332,44555,435,37032,2,37255,3
435,40905,3,41047,4,142,2011,2012,,,,44555,44697,435,37255,3,37397,4
435,41047,4,41048,5,1,2012,2012,,,,44697,44698,435,37397,4,37398,5
435,41048,5,41117,3,69,2012,2012,,,,44698,44767,435,37398,5,37467,3
435,41117,3,41270,4,153,2012,2012,,,,44767,44920,435,37467,3,37620,4
435,41270,4,42366,6,1096,2012,2015,,,,44920,46016,435,37620,4,38716,6
435,41270,6,42001,5,731,2012,2014,,,,44920,45651,435,37620,6,38351,5
435,42001,5,42366,5,365,2014,2015,,,,45651,46016,435,38351,5,38716,5
436,40905,4,42366,4,1461,2011,2015,,,,44555,46016,436,37255,4,38716,4
438,39960,3,42366,3,2406,2009,2015,,,,43610,46016,438,36310,3,38716,3
439,39960,4,41270,5,1310,2009,2012,,,,43610,44920,439,36310,4,37620,5
439,41270,5,41513,5,243,2012,2013,,,,44920,45163,439,37620,5,37863,5
439,41513,5,41778,6,265,2013,2014,,,,45163,45428,439,37863,5,38128,6
442,41200,3,42366,3,1166,2012,2015,,,,44850,46016,442,37550,3,38716,3
443,39952,3,40317,3,365,2009,2010,,,,43602,43967,443,36302,3,36667,3
443,40317,3,42366,3,2049,2010,2015,,,,43967,46016,443,36667,3,38716,3
443,40540,3,42366,3,1826,2010,2015,,,,44190,46016,443,36890,3,38716,3
444,40418,2,41412,3,994,2010,2013,,,,44068,45062,444,36768,2,37762,3
444,41412,3,42001,3,589,2013,2014,,,,45062,45651,444,37762,3,38351,3
444,42001,3,42366,3,365,2014,2015,,,,45651,46016,444,38351,3,38716,3
445,40074,4,42366,4,2292,2009,2015,,,,43724,46016,445,36424,4,38716,4
446,40326,2,41635,3,1309,2010,2013,,,,43976,45285,446,36676,2,37985,3
446,41635,3,41787,3,152,2013,2014,,,,45285,45437,446,37985,3,38137,3
446,41787,3,42366,3,579,2014,2015,,,,45437,46016,446,38137,3,38716,3
447,41087,2,42366,2,1279,2012,2015,,,,44737,46016,447,37437,2,38716,2
448,42148,4,42366,4,218,2015,2015,,,,45798,46016,448,38498,4,38716,4
449,41412,3,42366,3,954,2013,2015,,,,45062,46016,449,37762,3,38716,3
450,39991,5,40174,4,183,2009,2009,,,,43641,43824,450,36341,5,36524,4
450,40174,4,40418,5,244,2009,2010,,,,43824,44068,450,36524,4,36768,5
450,40418,5,42366,5,1948,2010,2015,,,,44068,46016,450,36768,5,38716,5
450,40418,5,41047,5,629,2010,2012,,,,44068,44697,450,36768,5,37397,5
451,40043,5,42366,5,2323,2009,2015,,,,43693,46016,451,36393,5,38716,5
452,40540,6,40688,7,148,2010,2011,,,,44190,44338,452,36890,6,37038,7
452,40688,7,40835,7,147,2011,2011,,,,44338,44485,452,37038,7,37185,7
452,40835,7,40905,8,70,2011,2011,,,,44485,44555,452,37185,7,37255,8
453,40326,6,42366,6,2040,2010,2015,,,,43976,46016,453,36676,6,38716,6
454,40043,6,41443,5,1400,2009,2013,,,,43693,45093,454,36393,6,37793,5
454,41443,5,42366,5,923,2013,2015,,,,45093,46016,454,37793,5,38716,5
455,41270,4,42366,4,1096,2012,2015,,,,44920,46016,455,37620,4,38716,4
456,41940,6,42366,6,426,2014,2015,,,,45590,46016,456,38290,6,38716,6
457,39957,6,40743,7,786,2009,2011,,,,43607,44393,457,36307,6,37093,7
457,40743,7,42001,6,1258,2011,2014,,,,44393,45651,457,37093,7,38351,6
457,42001,6,42366,6,365,2014,2015,,,,45651,46016,457,38351,6,38716,6
458,41635,5,41818,4,183,2013,2014,,,,45285,45468,458,37985,5,38168,4
458,41818,4,42366,4,548,2014,2015,,,,45468,46016,458,38168,4,38716,4
459,40805,3,41626,3,821,2011,2013,,,,44455,45276,459,37155,3,37976,3
459,41626,3,42366,3,740,2013,2015,,,,45276,46016,459,37976,3,38716,3
460,41412,6,42366,6,954,2013,2015,,,,45062,46016,460,37762,6,38716,6
462,40052,3,41778,3,1726,2009,2014,,,,43702,45428,462,36402,3,38128,3
462,41778,3,42366,3,588,2014,2015,,,,45428,46016,462,38128,3,38716,3
464,41513,2,42366,2,853,2013,2015,,,,45163,46016,464,37863,2,38716,2
465,40682,5,41047,6,365,2011,2012,,,,44332,44697,465,37032,5,37397,6
465,41047,6,41170,6,123,2012,2012,,,,44697,44820,465,37397,6,37520,6
465,41170,6,42366,6,1196,2012,2015,,,,44820,46016,465,37520,6,38716,6
467,41270,4,42366,3,1096,2012,2015,,,,44920,46016,467,37620,4,38716,3
467,41270,3,42366,3,1096,2012,2015,,,,44920,46016,467,37620,3,38716,3
468,40540,5,42366,5,1826,2010,2015,,,,44190,46016,468,36890,5,38716,5
469,40321,3,41270,3,949,2010,2012,,,,43971,44920,469,36671,3,37620,3
469,41270,3,42366,3,1096,2012,2015,,,,44920,46016,469,37620,3,38716,3
470,40043,3,40174,3,131,2009,2009,,,,43693,43824,470,36393,3,36524,3
470,40174,3,42366,3,2192,2009,2015,,,,43824,46016,470,36524,3,38716,3
471,40326,4,41270,5,944,2010,2012,,,,43976,44920,471,36676,4,37620,5
471,41270,5,41778,5,508,2012,2014,,,,44920,45428,471,37620,5,38128,5
471,41778,5,41839,5,61,2014,2014,,,,45428,45489,471,38128,5,38189,5
471,41839,5,42366,5,527,2014,2015,,,,45489,46016,471,38189,5,38716,5
472,40691,2,42336,2,1645,2011,2015,,,,44341,45986,472,37041,2,38686,2
472,42336,2,42366,2,30,2015,2015,,,,45986,46016,472,38686,2,38716,2
473,40052,4,40781,4,729,2009,2011,,,,43702,44431,473,36402,4,37131,4
473,40781,4,41412,4,631,2011,2013,,,,44431,45062,473,37131,4,37762,4
473,41412,4,42366,4,954,2013,2015,,,,45062,46016,473,37762,4,38716,4
474,40326,6,41209,6,883,2010,2012,,,,43976,44859,474,36676,6,37559,6
474,41209,6,41901,6,692,2012,2014,,,,44859,45551,474,37559,6,38251,6
474,41901,6,42366,6,465,2014,2015,,,,45551,46016,474,38251,6,38716,6
475,41870,2,42366,2,496,2014,2015,,,,45520,46016,475,38220,2,38716,2
476,40510,4,40835,4,325,2010,2011,,,,44160,44485,476,36860,4,37185,4
476,40835,4,42001,3,1166,2011,2014,,,,44485,45651,476,37185,4,38351,3
476,42001,3,42366,3,365,2014,2015,,,,45651,46016,476,38351,3,38716,3
477,41056,2,41412,3,356,2012,2013,,,,44706,45062,477,37406,2,37762,3
477,41412,3,42366,3,954,2013,2015,,,,45062,46016,477,37762,3,38716,3
478,41778,2,42366,2,588,2014,2015,,,,45428,46016,478,38128,2,38716,2
479,39985,3,41412,4,1427,2009,2013,,,,43635,45062,479,36335,3,37762,4
479,41412,4,42001,4,589,2013,2014,,,,45062,45651,479,37762,4,38351,4
479,42001,4,42366,4,365,2014,2015,,,,45651,46016,479,38351,4,38716,4
480,40012,3,41412,4,1400,2009,2013,,,,43662,45062,480,36362,3,37762,4
480,41412,4,42001,4,589,2013,2014,,,,45062,45651,480,37762,4,38351,4
480,42001,4,42366,4,365,2014,2015,,,,45651,46016,480,38351,4,38716,4
481,40357,3,40835,4,478,2010,2011,,,,44007,44485,481,36707,3,37185,4
481,40835,4,41056,5,221,2011,2012,,,,44485,44706,481,37185,4,37406,5
481,41056,5,42366,5,1310,2012,2015,,,,44706,46016,481,37406,5,38716,5
482,39954,2,42366,2,2412,2009,2015,,,,43604,46016,482,36304,2,38716,2
483,40317,3,42366,3,2049,2010,2015,,,,43967,46016,483,36667,3,38716,3
484,41270,3,41421,4,151,2012,2013,,,,44920,45071,484,37620,3,37771,4
484,41421,4,42366,4,945,2013,2015,,,,45071,46016,484,37771,4,38716,4
487,40440,3,40686,4,246,2010,2011,,,,44090,44336,487,36790,3,37036,4
487,40686,4,42366,4,1680,2011,2015,,,,44336,46016,487,37036,4,38716,4
488,40540,3,42366,3,1826,2010,2015,,,,44190,46016,488,36890,3,38716,3
489,41268,3,41270,3,2,2012,2012,,,,44918,44920,489,37618,3,37620,3
489,41270,3,41935,3,665,2012,2014,,,,44920,45585,489,37620,3,38285,3
489,41935,3,42366,3,431,2014,2015,,,,45585,46016,489,38285,3,38716,3
491,41779,3,42366,3,587,2014,2015,,,,45429,46016,491,38129,3,38716,3
493,41452,3,42366,3,914,2013,2015,,,,45102,46016,493,37802,3,38716,3
495,39951,5,39960,6,9,2009,2009,,,,43601,43610,495,36301,5,36310,6
495,39960,6,41817,6,1857,2009,2014,,,,43610,45467,495,36310,6,38167,6
495,41817,6,42366,6,549,2014,2015,,,,45467,46016,495,38167,6,38716,6
496,41209,4,42366,4,1157,2012,2015,,,,44859,46016,496,37559,4,38716,4
497,40540,2,42366,2,1826,2010,2015,,,,44190,46016,497,36890,2,38716,2
498,41839,6,42366,6,527,2014,2015,,,,45489,46016,498,38189,6,38716,6
499,40174,8,42366,8,2192,2009,2015,,,,43824,46016,499,36524,8,38716,8
500,41412,5,41787,5,375,2013,2014,,,,45062,45437,500,37762,5,38137,5
500,41787,5,42366,5,579,2014,2015,,,,45437,46016,500,38137,5,38716,5
501,40174,5,40317,5,143,2009,2010,,,,43824,43967,501,36524,5,36667,5
501,40317,5,40326,6,9,2010,2010,,,,43967,43976,501,36667,5,36676,6
501,40326,6,40691,7,365,2010,2011,,,,43976,44341,501,36676,6,37041,7
503,39951,3,41635,2,1684,2009,2013,,,,43601,45285,503,36301,3,37985,2
503,41635,2,42366,2,731,2013,2015,,,,45285,46016,503,37985,2,38716,2
504,40043,5,40318,4,275,2009,2010,,,,43693,43968,504,36393,5,36668,4
504,40318,4,40866,5,548,2010,2011,,,,43968,44516,504,36668,4,37216,5
504,40866,5,41443,6,577,2011,2013,,,,44516,45093,504,37216,5,37793,6
504,41443,6,42366,6,923,2013,2015,,,,45093,46016,504,37793,6,38716,6
507,40074,3,40905,3,831,2009,2011,,,,43724,44555,507,36424,3,37255,3
507,40905,3,42366,3,1461,2011,2015,,,,44555,46016,507,37255,3,38716,3
509,41270,4,41421,4,151,2012,2013,,,,44920,45071,509,37620,4,37771,4
509,41421,4,41635,4,214,2013,2013,,,,45071,45285,509,37771,4,37985,4
509,41635,4,42366,4,731,2013,2015,,,,45285,46016,509,37985,4,38716,4
510,40510,3,42366,3,1856,2010,2015,,,,44160,46016,510,36860,3,38716,3
511,41412,4,42366,4,954,2013,2015,,,,45062,46016,511,37762,4,38716,4
512,41170,4,42366,4,1196,2012,2015,,,,44820,46016,512,37520,4,38716,4
513,40317,4,41635,4,1318,2010,2013,,,,43967,45285,513,36667,4,37985,4
513,41635,4,42366,4,731,2013,2015,,,,45285,46016,513,37985,4,38716,4
514,41412,2,42366,2,954,2013,2015,,,,45062,46016,514,37762,2,38716,2
516,40691,2,42366,2,1675,2011,2015,,,,44341,46016,516,37041,2,38716,2
517,39960,4,42366,4,2406,2009,2015,,,,43610,46016,517,36310,4,38716,4
520,41270,3,41778,3,508,2012,2014,,,,44920,45428,520,37620,3,38128,3
520,41778,3,42366,3,588,2014,2015,,,,45428,46016,520,38128,3,38716,3
521,40691,3,42366,3,1675,2011,2015,,,,44341,46016,521,37041,3,38716,3
522,40326,3,41635,4,1309,2010,2013,,,,43976,45285,522,36676,3,37985,4
522,41635,4,42366,4,731,2013,2015,,,,45285,46016,522,37985,4,38716,4
523,39951,5,40682,4,731,2009,2011,,,,43601,44332,523,36301,5,37032,4
524,40317,2,41056,1,739,2010,2012,,,,43967,44706,524,36667,2,37406,1
524,41056,1,42366,1,1310,2012,2015,,,,44706,46016,524,37406,1,38716,1
525,41574,4,42366,4,792,2013,2015,,,,45224,46016,525,37924,4,38716,4
526,41200,3,42001,3,801,2012,2014,,,,44850,45651,526,37550,3,38351,3
526,42001,3,42366,3,365,2014,2015,,,,45651,46016,526,38351,3,38716,3
527,41812,3,42001,4,189,2014,2014,,,,45462,45651,527,38162,3,38351,4
527,42001,4,42366,4,365,2014,2015,,,,45651,46016,527,38351,4,38716,4
528,40324,5,40540,4,216,2010,2010,,,,43974,44190,528,36674,5,36890,4
529,42001,3,42366,3,365,2014,2015,,,,45651,46016,529,38351,3,38716,3
530,39982,6,40021,5,39,2009,2009,,,,43632,43671,530,36332,6,36371,5
530,40021,5,40326,7,305,2009,2010,,,,43671,43976,530,36371,5,36676,7
530,40326,7,40409,8,83,2010,2010,,,,43976,44059,530,36676,7,36759,8
530,41412,7,41910,6,498,2013,2014,,,,45062,45560,530,37762,7,38260,6
530,41910,6,42366,6,456,2014,2015,,,,45560,46016,530,38260,6,38716,6
531,41635,2,41962,2,327,2013,2014,,,,45285,45612,531,37985,2,38312,2
531,41962,2,42366,2,404,2014,2015,,,,45612,46016,531,38312,2,38716,2
532,41270,3,42366,3,1096,2012,2015,,,,44920,46016,532,37620,3,38716,3
533,40540,4,42366,4,1826,2010,2015,,,,44190,46016,533,36890,4,38716,4
534,41209,3,42366,3,1157,2012,2015,,,,44859,46016,534,37559,3,38716,3
535,40540,4,41056,4,516,2010,2012,,,,44190,44706,535,36890,4,37406,4
535,41056,4,42366,4,1310,2012,2015,,,,44706,46016,535,37406,4,38716,4
536,39951,3,40682,2,731,2009,2011,,,,43601,44332,536,36301,3,37032,2
536,40682,2,41778,2,1096,2011,2014,,,,44332,45428,536,37032,2,38128,2
536,41778,2,42366,2,588,2014,2015,,,,45428,46016,536,38128,2,38716,2
538,39982,4,40387,4,405,2009,2010,,,,43632,44037,538,36332,4,36737,4
538,40387,4,40783,4,396,2010,2011,,,,44037,44433,538,36737,4,37133,4
538,40783,4,41839,4,1056,2011,2014,,,,44433,45489,538,37133,4,38189,4
538,41839,4,42366,4,527,2014,2015,,,,45489,46016,538,38189,4,38716,4
539,41047,4,42001,4,954,2012,2014,,,,44697,45651,539,37397,4,38351,4
539,42001,4,42366,4,365,2014,2015,,,,45651,46016,539,38351,4,38716,4
540,41635,3,41787,3,152,2013,2014,,,,45285,45437,540,37985,3,38137,3
540,41787,3,42366,3,579,2014,2015,,,,45437,46016,540,38137,3,38716,3
541,40905,5,41412,6,507,2011,2013,,,,44555,45062,541,37255,5,37762,6
541,41412,6,42366,6,954,2013,2015,,,,45062,46016,541,37762,6,38716,6
542,40691,3,41270,3,579,2011,2012,,,,44341,44920,542,37041,3,37620,3
542,41270,3,42366,3,1096,2012,2015,,,,44920,46016,542,37620,3,38716,3
543,40083,5,42366,5,2283,2009,2015,,,,43733,46016,543,36433,5,38716,5
545,41240,3,42366,3,1126,2012,2015,,,,44890,46016,545,37590,3,38716,3
546,40752,4,42001,4,1249,2011,2014,,,,44402,45651,546,37102,4,38351,4
546,42001,4,42366,4,365,2014,2015,,,,45651,46016,546,38351,4,38716,4
547,40691,6,40905,6,214,2011,2011,,,,44341,44555,547,37041,6,37255,6
547,41605,8,42366,8,761,2013,2015,,,,45255,46016,547,37955,8,38716,8
548,40540,3,42366,3,1826,2010,2015,,,,44190,46016,548,36890,3,38716,3
549,41605,3,42366,3,761,2013,2015,,,,45255,46016,549,37955,3,38716,3
551,41078,3,41635,2,557,2012,2013,,,,44728,45285,551,37428,3,37985,2
551,41635,2,42366,2,731,2013,2015,,,,45285,46016,551,37985,2,38716,2
552,41056,4,41117,3,61,2012,2012,,,,44706,44767,552,37406,4,37467,3
552,41117,3,42366,3,1249,2012,2015,,,,44767,46016,552,37467,3,38716,3
553,40317,6,41053,8,736,2010,2012,,,,43967,44703,553,36667,6,37403,8
553,41179,7,41270,6,91,2012,2012,,,,44829,44920,553,37529,7,37620,6
553,41270,6,42366,6,1096,2012,2015,,,,44920,46016,553,37620,6,38716,6
554,40378,4,42366,4,1988,2010,2015,,,,44028,46016,554,36728,4,38716,4
555,40682,5,40905,6,223,2011,2011,,,,44332,44555,555,37032,5,37255,6
555,40905,6,41635,7,730,2011,2013,,,,44555,45285,555,37255,6,37985,7
555,41635,7,42366,7,731,2013,2015,,,,45285,46016,555,37985,7,38716,7
556,40905,5,42152,6,1247,2011,2015,,,,44555,45802,556,37255,5,38502,6
556,42152,6,42366,6,214,2015,2015,,,,45802,46016,556,38502,6,38716,6
557,40807,3,41635,3,828,2011,2013,,,,44457,45285,557,37157,3,37985,3
557,41635,3,42366,3,731,2013,2015,,,,45285,46016,557,37985,3,38716,3
558,40174,6,41047,6,873,2009,2012,,,,43824,44697,558,36524,6,37397,6
558,41047,6,42366,6,1319,2012,2015,,,,44697,46016,558,37397,6,38716,6
559,40113,6,40174,6,61,2009,2009,,,,43763,43824,559,36463,6,36524,6
559,40174,6,40682,6,508,2009,2011,,,,43824,44332,559,36524,6,37032,6
559,40682,6,41139,7,457,2011,2012,,,,44332,44789,559,37032,6,37489,7
559,41139,7,41270,6,131,2012,2012,,,,44789,44920,559,37489,7,37620,6
559,41270,6,41412,7,142,2012,2013,,,,44920,45062,559,37620,6,37762,7
559,41412,7,41565,6,153,2013,2013,,,,45062,45215,559,37762,7,37915,6
560,41139,3,41778,2,639,2012,2014,,,,44789,45428,560,37489,3,38128,2
560,41778,2,42366,2,588,2014,2015,,,,45428,46016,560,38128,2,38716,2
561,41139,2,42001,2,862,2012,2014,,,,44789,45651,561,37489,2,38351,2
561,42001,2,42366,2,365,2014,2015,,,,45651,46016,561,38351,2,38716,2
562,41108,3,42001,2,893,2012,2014,,,,44758,45651,562,37458,3,38351,2
562,42001,2,42366,2,365,2014,2015,,,,45651,46016,562,38351,2,38716,2
564,40113,4,40418,3,305,2009,2010,,,,43763,44068,564,36463,4,36768,3
564,40418,3,41870,3,1452,2010,2014,,,,44068,45520,564,36768,3,38220,3
564,41870,3,42366,3,496,2014,2015,,,,45520,46016,564,38220,3,38716,3
566,41270,2,42366,2,1096,2012,2015,,,,44920,46016,566,37620,2,38716,2
567,41261,2,42366,2,1105,2012,2015,,,,44911,46016,567,37611,2,38716,2
568,41270,2,42366,2,1096,2012,2015,,,,44920,46016,568,37620,2,38716,2
569,41240,3,42366,3,1126,2012,2015,,,,44890,46016,569,37590,3,38716,3
570,41270,2,42366,2,1096,2012,2015,,,,44920,46016,570,37620,2,38716,2
571,39960,5,40540,5,580,2009,2010,,,,43610,44190,571,36310,5,36890,5
571,40540,5,40835,6,295,2010,2011,,,,44190,44485,571,36890,5,37185,6
571,40835,6,42366,6,1531,2011,2015,,,,44485,46016,571,37185,6,38716,6
572,42001,4,42366,4,365,2014,2015,,,,45651,46016,572,38351,4,38716,4
574,41421,3,42366,3,945,2013,2015,,,,45071,46016,574,37771,3,38716,3
575,40783,3,40905,2,122,2011,2011,,,,44433,44555,575,37133,3,37255,2
575,40905,2,42366,2,1461,2011,2015,,,,44555,46016,575,37255,2,38716,2
576,39958,4,42366,4,2408,2009,2015,,,,43608,46016,576,36308,4,38716,4
577,39951,3,40540,3,589,2009,2010,,,,43601,44190,577,36301,3,36890,3
577,40540,3,40682,3,142,2010,2011,,,,44190,44332,577,36890,3,37032,3
577,40682,3,42366,3,1684,2011,2015,,,,44332,46016,577,37032,3,38716,3
578,39951,3,40531,3,580,2009,2010,,,,43601,44181,578,36301,3,36881,3
578,40531,3,40682,3,151,2010,2011,,,,44181,44332,578,36881,3,37032,3
578,40682,3,42366,3,1684,2011,2015,,,,44332,46016,578,37032,3,38716,3
579,40317,2,41231,3,914,2010,2012,,,,43967,44881,579,36667,2,37581,3
580,40326,2,41231,3,905,2010,2012,,,,43976,44881,580,36676,2,37581,3
580,41231,3,42366,3,1135,2012,2015,,,,44881,46016,580,37581,3,38716,3
581,40745,6,41778,5,1033,2011,2014,,,,44395,45428,581,37095,6,38128,5
581,41778,5,41992,5,214,2014,2014,,,,45428,45642,581,38128,5,38342,5
581,41992,5,42366,5,374,2014,2015,,,,45642,46016,581,38342,5,38716,5
582,41535,3,42366,3,831,2013,2015,,,,45185,46016,582,37885,3,38716,3
583,40174,5,41482,6,1308,2009,2013,,,,43824,45132,583,36524,5,37832,6
583,41482,6,42213,6,731,2013,2015,,,,45132,45863,583,37832,6,38563,6
583,42213,6,42366,6,153,2015,2015,,,,45863,46016,583,38563,6,38716,6
584,41452,4,42366,4,914,2013,2015,,,,45102,46016,584,37802,4,38716,4
585,39953,4,40905,4,952,2009,2011,,,,43603,44555,585,36303,4,37255,4
585,40905,4,41635,4,730,2011,2013,,,,44555,45285,585,37255,4,37985,4
585,41635,4,42152,5,517,2013,2015,,,,45285,45802,585,37985,4,38502,5
585,42152,5,42366,5,214,2015,2015,,,,45802,46016,585,38502,5,38716,5
586,40682,4,41048,5,366,2011,2012,,,,44332,44698,586,37032,4,37398,5
586,41048,5,42366,5,1318,2012,2015,,,,44698,46016,586,37398,5,38716,5
587,41117,5,41574,5,457,2012,2013,,,,44767,45224,587,37467,5,37924,5
587,41574,5,42366,5,792,2013,2015,,,,45224,46016,587,37924,5,38716,5
588,40682,6,41202,6,520,2011,2012,,,,44332,44852,588,37032,6,37552,6
588,41202,6,41443,7,241,2012,2013,,,,44852,45093,588,37552,6,37793,7
588,41443,7,41778,7,335,2013,2014,,,,45093,45428,588,37793,7,38128,7
588,41778,7,42366,7,588,2014,2015,,,,45428,46016,588,38128,7,38716,7
589,40540,5,42366,5,1826,2010,2015,,,,44190,46016,589,36890,5,38716,5
590,41412,5,42001,5,589,2013,2014,,,,45062,45651,590,37762,5,38351,5
590,42001,5,42366,5,365,2014,2015,,,,45651,46016,590,38351,5,38716,5
591,40721,2,42366,2,1645,2011,2015,,,,44371,46016,591,37071,2,38716,2
592,39960,4,40905,4,945,2009,2011,,,,43610,44555,592,36310,4,37255,4
593,40174,4,41056,4,882,2009,2012,,,,43824,44706,593,36524,4,37406,4
593,41056,4,41200,7,144,2012,2012,,,,44706,44850,593,37406,4,37550,7
593,41200,7,41240,5,40,2012,2012,,,,44850,44890,593,37550,7,37590,5
593,41240,5,41635,5,395,2012,2013,,,,44890,45285,593,37590,5,37985,5
593,41635,5,42366,5,731,2013,2015,,,,45285,46016,593,37985,5,38716,5
594,40324,3,42366,3,2042,2010,2015,,,,43974,46016,594,36674,3,38716,3
595,40409,4,41778,5,1369,2010,2014,,,,44059,45428,595,36759,4,38128,5
595,41778,5,42001,4,223,2014,2014,,,,45428,45651,595,38128,5,38351,4
595,42001,4,42366,4,365,2014,2015,,,,45651,46016,595,38351,4,38716,4
596,40174,7,40440,6,266,2009,2010,,,,43824,44090,596,36524,7,36790,6
596,40440,6,41473,6,1033,2010,2013,,,,44090,45123,596,36790,6,37823,6
596,41473,6,42366,6,893,2013,2015,,,,45123,46016,596,37823,6,38716,6
598,40691,7,40905,8,214,2011,2011,,,,44341,44555,598,37041,7,37255,8
598,40905,8,42366,8,1461,2011,2015,,,,44555,46016,598,37255,8,38716,8
599,41414,3,42366,3,952,2013,2015,,,,45064,46016,599,37764,3,38716,3
600,41420,3,42366,3,946,2013,2015,,,,45070,46016,600,37770,3,38716,3
601,41270,4,42143,4,873,2012,2015,,,,44920,45793,601,37620,4,38493,4
601,42143,4,42366,4,223,2015,2015,,,,45793,46016,601,38493,4,38716,4
602,40326,5,40774,4,448,2010,2011,,,,43976,44424,602,36676,5,37124,4
602,40774,4,42366,4,1592,2011,2015,,,,44424,46016,602,37124,4,38716,4
603,42001,3,42366,3,365,2014,2015,,,,45651,46016,603,38351,3,38716,3
604,39960,4,41117,4,1157,2009,2012,,,,43610,44767,604,36310,4,37467,4
604,41117,4,41270,4,153,2012,2012,,,,44767,44920,604,37467,4,37620,4
604,41270,4,42366,5,1096,2012,2015,,,,44920,46016,604,37620,4,38716,5
604,41270,5,41421,7,151,2012,2013,,,,44920,45071,604,37620,5,37771,7
604,41421,7,42366,7,945,2013,2015,,,,45071,46016,604,37771,7,38716,7
605,39960,4,42366,4,2406,2009,2015,,,,43610,46016,605,36310,4,38716,4
606,40174,6,40317,7,143,2009,2010,,,,43824,43967,606,36524,6,36667,7
606,40317,7,40774,7,457,2010,2011,,,,43967,44424,606,36667,7,37124,7
607,40805,4,42366,4,1561,2011,2015,,,,44455,46016,607,37155,4,38716,4
608,40682,2,42366,2,1684,2011,2015,,,,44332,46016,608,37032,2,38716,2
609,40866,4,42366,4,1500,2011,2015,,,,44516,46016,609,37216,4,38716,4
610,40174,5,42366,5,2192,2009,2015,,,,43824,46016,610,36524,5,38716,5
611,39960,4,41056,4,1096,2009,2012,,,,43610,44706,611,36310,4,37406,4
611,41056,4,41170,5,114,2012,2012,,,,44706,44820,611,37406,4,37520,5
611,41170,5,41605,6,435,2012,2013,,,,44820,45255,611,37520,5,37955,6
611,41605,6,42366,6,761,2013,2015,,,,45255,46016,611,37955,6,38716,6
612,39982,4,40418,3,436,2009,2010,,,,43632,44068,612,36332,4,36768,3
613,41087,4,42366,4,1279,2012,2015,,,,44737,46016,613,37437,4,38716,4
614,40688,3,42366,3,1678,2011,2015,,,,44338,46016,614,37038,3,38716,3
615,41056,4,42366,4,1310,2012,2015,,,,44706,46016,615,37406,4,38716,4
615,41056,4,42366,4,1310,2012,2015,,,,44706,46016,615,37406,4,38716,4
616,40470,4,40682,7,212,2010,2011,,,,44120,44332,616,36820,4,37032,7
616,40682,7,40691,6,9,2011,2011,,,,44332,44341,616,37032,7,37041,6
616,40691,6,40905,5,214,2011,2011,,,,44341,44555,616,37041,6,37255,5
617,40174,4,42305,4,2131,2009,2015,,,,43824,45955,617,36524,4,38655,4
617,42305,4,42366,4,61,2015,2015,,,,45955,46016,617,38655,4,38716,4
618,40378,4,40844,3,466,2010,2011,,,,44028,44494,618,36728,4,37194,3
618,40844,3,42366,3,1522,2011,2015,,,,44494,46016,618,37194,3,38716,3
619,40905,3,42366,3,1461,2011,2015,,,,44555,46016,619,37255,3,38716,3
620,40805,2,42366,2,1561,2011,2015,,,,44455,46016,620,37155,2,38716,2
621,39951,5,40510,6,559,2009,2010,,,,43601,44160,621,36301,5,36860,6
621,40510,6,40814,5,304,2010,2011,,,,44160,44464,621,36860,6,37164,5
621,40814,5,42366,5,1552,2011,2015,,,,44464,46016,621,37164,5,38716,5
622,41148,4,41635,4,487,2012,2013,,,,44798,45285,622,37498,4,37985,4
622,41635,4,42366,4,731,2013,2015,,,,45285,46016,622,37985,4,38716,4
623,40905,3,41270,3,365,2011,2012,,,,44555,44920,623,37255,3,37620,3
623,41270,3,42366,3,1096,2012,2015,,,,44920,46016,623,37620,3,38716,3
624,40774,3,41270,3,496,2011,2012,,,,44424,44920,624,37124,3,37620,3
624,41270,3,42366,3,1096,2012,2015,,,,44920,46016,624,37620,3,38716,3
625,40713,3,41270,3,557,2011,2012,,,,44363,44920,625,37063,3,37620,3
625,41270,3,42366,3,1096,2012,2015,,,,44920,46016,625,37620,3,38716,3
626,39960,3,40317,2,357,2009,2010,,,,43610,43967,626,36310,3,36667,2
626,40317,2,41047,2,730,2010,2012,,,,43967,44697,626,36667,2,37397,2
626,41047,2,42366,2,1319,2012,2015,,,,44697,46016,626,37397,2,38716,2
627,40348,3,42366,3,2018,2010,2015,,,,43998,46016,627,36698,3,38716,3
628,40318,5,40540,4,222,2010,2010,,,,43968,44190,628,36668,5,36890,4
628,40540,4,41809,5,1269,2010,2014,,,,44190,45459,628,36890,4,38159,5
628,41809,5,42366,5,557,2014,2015,,,,45459,46016,628,38159,5,38716,5
629,41635,3,42366,3,731,2013,2015,,,,45285,46016,629,37985,3,38716,3
630,40074,3,40479,2,405,2009,2010,,,,43724,44129,630,36424,3,36829,2
631,40012,4,40326,4,314,2009,2010,,,,43662,43976,631,36362,4,36676,4
631,40326,4,40835,4,509,2010,2011,,,,43976,44485,631,36676,4,37185,4
631,40835,4,42366,4,1531,2011,2015,,,,44485,46016,631,37185,4,38716,4
632,41240,4,41635,4,395,2012,2013,,,,44890,45285,632,37590,4,37985,4
632,41635,4,42001,5,366,2013,2014,,,,45285,45651,632,37985,4,38351,5
632,42001,5,42366,5,365,2014,2015,,,,45651,46016,632,38351,5,38716,5
633,39956,3,41940,3,1984,2009,2014,,,,43606,45590,633,36306,3,38290,3
633,41940,3,42366,3,426,2014,2015,,,,45590,46016,633,38290,3,38716,3
634,40326,4,41270,3,944,2010,2012,,,,43976,44920,634,36676,4,37620,3
634,41270,3,42366,3,1096,2012,2015,,,,44920,46016,634,37620,3,38716,3
635,40174,6,40357,7,183,2009,2010,,,,43824,44007,635,36524,6,36707,7
636,40682,4,40713,5,31,2011,2011,,,,44332,44363,636,37032,4,37063,5
636,40713,5,40905,6,192,2011,2011,,,,44363,44555,636,37063,5,37255,6
636,40905,6,41052,6,147,2011,2012,,,,44555,44702,636,37255,6,37402,6
636,41052,6,41413,7,361,2012,2013,,,,44702,45063,636,37402,6,37763,7
636,41413,7,42366,7,953,2013,2015,,,,45063,46016,636,37763,7,38716,7
637,40174,5,40682,4,508,2009,2011,,,,43824,44332,637,36524,5,37032,4
637,40682,4,40722,3,40,2011,2011,,,,44332,44372,637,37032,4,37072,3
637,40722,3,42143,4,1421,2011,2015,,,,44372,45793,637,37072,3,38493,4
637,42143,4,42366,4,223,2015,2015,,,,45793,46016,637,38493,4,38716,4
638,40775,2,42001,2,1226,2011,2014,,,,44425,45651,638,37125,2,38351,2
638,42001,2,42366,2,365,2014,2015,,,,45651,46016,638,38351,2,38716,2
639,40083,6,40326,5,243,2009,2010,,,,43733,43976,639,36433,6,36676,5
640,40682,4,41108,3,426,2011,2012,,,,44332,44758,640,37032,4,37458,3
640,41108,3,42366,3,1258,2012,2015,,,,44758,46016,640,37458,3,38716,3
641,40174,4,40510,5,336,2009,2010,,,,43824,44160,641,36524,4,36860,5
641,40510,5,40540,6,30,2010,2010,,,,44160,44190,641,36860,5,36890,6
641,40540,6,41056,7,516,2010,2012,,,,44190,44706,641,36890,6,37406,7
641,41056,7,41117,6,61,2012,2012,,,,44706,44767,641,37406,7,37467,6
641,41117,6,41240,7,123,2012,2012,,,,44767,44890,641,37467,6,37590,7
641,41240,7,41270,8,30,2012,2012,,,,44890,44920,641,37590,7,37620,8
642,41910,1,42366,1,456,2014,2015,,,,45560,46016,642,38260,1,38716,1
643,40743,3,42366,3,1623,2011,2015,,,,44393,46016,643,37093,3,38716,3
644,40174,4,42366,4,2192,2009,2015,,,,43824,46016,644,36524,4,38716,4
645,39960,6,40682,7,722,2009,2011,,,,43610,44332,645,36310,6,37032,7
645,40682,7,40905,7,223,2011,2011,,,,44332,44555,645,37032,7,37255,7
646,39960,3,42001,3,2041,2009,2014,,,,43610,45651,646,36310,3,38351,3
646,42001,3,42366,3,365,2014,2015,,,,45651,46016,646,38351,3,38716,3
647,40510,4,41179,4,669,2010,2012,,,,44160,44829,647,36860,4,37529,4
647,41179,4,42366,4,1187,2012,2015,,,,44829,46016,647,37529,4,38716,4
648,40691,3,42366,3,1675,2011,2015,,,,44341,46016,648,37041,3,38716,3
649,40713,6,40905,6,192,2011,2011,,,,44363,44555,649,37063,6,37255,6
649,40905,6,41049,6,144,2011,2012,,,,44555,44699,649,37255,6,37399,6
649,41049,6,41574,7,525,2012,2013,,,,44699,45224,649,37399,6,37924,7
649,41574,7,42366,7,792,2013,2015,,,,45224,46016,649,37924,7,38716,7
650,39960,4,40409,3,449,2009,2010,,,,43610,44059,650,36310,4,36759,3
650,40409,3,40805,4,396,2010,2011,,,,44059,44455,650,36759,3,37155,4
650,40805,4,40905,4,100,2011,2011,,,,44455,44555,650,37155,4,37255,4
650,40905,4,41139,4,234,2011,2012,,,,44555,44789,650,37255,4,37489,4
650,41139,4,42143,4,1004,2012,2015,,,,44789,45793,650,37489,4,38493,4
650,42143,4,42366,4,223,2015,2015,,,,45793,46016,650,38493,4,38716,4
651,40317,4,40905,4,588,2010,2011,,,,43967,44555,651,36667,4,37255,4
651,40905,4,42366,4,1461,2011,2015,,,,44555,46016,651,37255,4,38716,4
653,40805,4,42366,4,1561,2011,2015,,,,44455,46016,653,37155,4,38716,4
653,42366,4,42366,4,0,2015,2015,,,,46016,46016,653,38716,4,38716,4
655,40896,2,42366,2,1470,2011,2015,,,,44546,46016,655,37246,2,38716,2
656,40777,2,40905,1,128,2011,2011,,,,44427,44555,656,37127,2,37255,1
656,40905,1,41778,2,873,2011,2014,,,,44555,45428,656,37255,1,38128,2
656,41778,2,42366,2,588,2014,2015,,,,45428,46016,656,38128,2,38716,2
657,40868,2,40905,2,37,2011,2011,,,,44518,44555,657,37218,2,37255,2
657,40905,2,42366,2,1461,2011,2015,,,,44555,46016,657,37255,2,38716,2
658,40540,1,42366,1,1826,2010,2015,,,,44190,46016,658,36890,1,38716,1
659,41270,3,42366,3,1096,2012,2015,,,,44920,46016,659,37620,3,38716,3
660,40104,3,40174,3,70,2009,2009,,,,43754,43824,660,36454,3,36524,3
660,40174,3,40905,4,731,2009,2011,,,,43824,44555,660,36524,3,37255,4
660,40905,4,42152,4,1247,2011,2015,,,,44555,45802,660,37255,4,38502,4
660,42152,4,42366,4,214,2015,2015,,,,45802,46016,660,38502,4,38716,4
662,41839,6,42366,6,527,2014,2015,,,,45489,46016,662,38189,6,38716,6
663,40317,3,40805,4,488,2010,2011,,,,43967,44455,663,36667,3,37155,4
663,40805,4,40905,3,100,2011,2011,,,,44455,44555,663,37155,4,37255,3
663,40905,3,41056,4,151,2011,2012,,,,44555,44706,663,37255,3,37406,4
663,41056,4,41078,5,22,2012,2012,,,,44706,44728,663,37406,4,37428,5
663,41078,5,42366,5,1288,2012,2015,,,,44728,46016,663,37428,5,38716,5
664,40752,3,42366,3,1614,2011,2015,,,,44402,46016,664,37102,3,38716,3
665,41870,4,42366,4,496,2014,2015,,,,45520,46016,665,38220,4,38716,4
667,40752,6,42366,6,1614,2011,2015,,,,44402,46016,667,37102,6,38716,6
668,40540,3,40783,3,243,2010,2011,,,,44190,44433,668,36890,3,37133,3
668,40783,3,41910,2,1127,2011,2014,,,,44433,45560,668,37133,3,38260,2
668,41910,2,42366,2,456,2014,2015,,,,45560,46016,668,38260,2,38716,2
669,40510,3,40682,3,172,2010,2011,,,,44160,44332,669,36860,3,37032,3
670,40684,2,40691,2,7,2011,2011,,,,44334,44341,670,37034,2,37041,2
670,40691,2,42366,2,1675,2011,2015,,,,44341,46016,670,37041,2,38716,2
671,40810,2,42366,2,1556,2011,2015,,,,44460,46016,671,37160,2,38716,2
673,40540,2,41141,2,601,2010,2012,,,,44190,44791,673,36890,2,37491,2
673,41141,2,42366,2,1225,2012,2015,,,,44791,46016,673,37491,2,38716,2
674,41052,7,41420,7,368,2012,2013,,,,44702,45070,674,37402,7,37770,7
674,41420,7,41787,8,367,2013,2014,,,,45070,45437,674,37770,7,38137,8
675,40348,4,40682,7,334,2010,2011,,,,43998,44332,675,36698,4,37032,7
675,40682,7,40805,8,123,2011,2011,,,,44332,44455,675,37032,7,37155,8
675,40805,8,41416,6,611,2011,2013,,,,44455,45066,675,37155,8,37766,6
675,41416,6,42366,6,950,2013,2015,,,,45066,46016,675,37766,6,38716,6
676,40875,4,41056,5,181,2011,2012,,,,44525,44706,676,37225,4,37406,5
676,41056,5,41270,5,214,2012,2012,,,,44706,44920,676,37406,5,37620,5
676,41270,5,42366,5,1096,2012,2015,,,,44920,46016,676,37620,5,38716,5
678,41270,3,42366,3,1096,2012,2015,,,,44920,46016,678,37620,3,38716,3
680,39951,4,40317,3,366,2009,2010,,,,43601,43967,680,36301,4,36667,3
680,40317,3,41818,3,1501,2010,2014,,,,43967,45468,680,36667,3,38168,3
680,41818,3,41908,3,90,2014,2014,,,,45468,45558,680,38168,3,38258,3
680,41908,3,42366,3,458,2014,2015,,,,45558,46016,680,38258,3,38716,3
681,40326,6,40687,7,361,2010,2011,,,,43976,44337,681,36676,6,37037,7
682,39951,4,40357,3,406,2009,2010,,,,43601,44007,682,36301,4,36707,3
682,40357,3,42001,3,1644,2010,2014,,,,44007,45651,682,36707,3,38351,3
682,42001,3,42366,3,365,2014,2015,,,,45651,46016,682,38351,3,38716,3
683,39951,4,40317,3,366,2009,2010,,,,43601,43967,683,36301,4,36667,3
683,40317,3,41818,3,1501,2010,2014,,,,43967,45468,683,36667,3,38168,3
683,41818,3,42366,3,548,2014,2015,,,,45468,46016,683,38168,3,38716,3
684,40682,3,42366,3,1684,2011,2015,,,,44332,46016,684,37032,3,38716,3
685,40174,6,40905,7,731,2009,2011,,,,43824,44555,685,36524,6,37255,7
685,40905,7,41482,6,577,2011,2013,,,,44555,45132,685,37255,7,37832,6
685,41482,6,41635,8,153,2013,2013,,,,45132,45285,685,37832,6,37985,8
686,40440,4,40844,4,404,2010,2011,,,,44090,44494,686,36790,4,37194,4
686,40844,4,40905,5,61,2011,2011,,,,44494,44555,686,37194,4,37255,5
686,40905,5,41117,5,212,2011,2012,,,,44555,44767,686,37255,5,37467,5
686,41117,5,42366,5,1249,2012,2015,,,,44767,46016,686,37467,5,38716,5
687,40682,5,40783,4,101,2011,2011,,,,44332,44433,687,37032,5,37133,4
687,40783,4,41117,5,334,2011,2012,,,,44433,44767,687,37133,4,37467,5
687,41117,5,42001,5,884,2012,2014,,,,44767,45651,687,37467,5,38351,5
687,42001,5,42366,5,365,2014,2015,,,,45651,46016,687,38351,5,38716,5
688,41416,3,41839,3,423,2013,2014,,,,45066,45489,688,37766,3,38189,3
688,41839,3,42366,3,527,2014,2015,,,,45489,46016,688,38189,3,38716,3
691,40449,3,41412,4,963,2010,2013,,,,44099,45062,691,36799,3,37762,4
691,41412,4,42001,5,589,2013,2014,,,,45062,45651,691,37762,4,38351,5
691,42001,5,42366,5,365,2014,2015,,,,45651,46016,691,38351,5,38716,5
692,40409,3,40682,4,273,2010,2011,,,,44059,44332,692,36759,3,37032,4
692,40682,4,41148,6,466,2011,2012,,,,44332,44798,692,37032,4,37498,6
692,41148,6,41412,5,264,2012,2013,,,,44798,45062,692,37498,6,37762,5
692,41412,5,41605,5,193,2013,2013,,,,45062,45255,692,37762,5,37955,5
692,41605,5,42366,5,761,2013,2015,,,,45255,46016,692,37955,5,38716,5
693,42001,4,42366,4,365,2014,2015,,,,45651,46016,693,38351,4,38716,4
694,40691,4,42366,4,1675,2011,2015,,,,44341,46016,694,37041,4,38716,4
695,41047,3,42366,3,1319,2012,2015,,,,44697,46016,695,37397,3,38716,3
696,40409,3,42183,4,1774,2010,2015,,,,44059,45833,696,36759,3,38533,4
696,42183,4,42366,4,183,2015,2015,,,,45833,46016,696,38533,4,38716,4
697,39960,2,42366,2,2406,2009,2015,,,,43610,46016,697,36310,2,38716,2
698,41535,4,42366,4,831,2013,2015,,,,45185,46016,698,37885,4,38716,4
700,39951,6,41421,5,1470,2009,2013,,,,43601,45071,700,36301,6,37771,5
700,41421,5,42213,6,792,2013,2015,,,,45071,45863,700,37771,5,38563,6
700,42213,6,42366,6,153,2015,2015,,,,45863,46016,700,38563,6,38716,6
701,40713,5,40905,5,192,2011,2011,,,,44363,44555,701,37063,5,37255,5
701,40905,5,41412,6,507,2011,2013,,,,44555,45062,701,37255,5,37762,6
701,41412,6,41787,7,375,2013,2014,,,,45062,45437,701,37762,6,38137,7
701,41787,7,42001,7,214,2014,2014,,,,45437,45651,701,38137,7,38351,7
701,42001,7,42366,8,365,2014,2015,,,,45651,46016,701,38351,7,38716,8
701,42001,8,42366,8,365,2014,2015,,,,45651,46016,701,38351,8,38716,8
703,41056,3,41785,4,729,2012,2014,,,,44706,45435,703,37406,3,38135,4
703,41785,4,42366,4,581,2014,2015,,,,45435,46016,703,38135,4,38716,4
704,40682,2,41778,2,1096,2011,2014,,,,44332,45428,704,37032,2,38128,2
704,41778,2,42366,2,588,2014,2015,,,,45428,46016,704,38128,2,38716,2
705,40174,3,40317,3,143,2009,2010,,,,43824,43967,705,36524,3,36667,3
705,40317,3,40440,3,123,2010,2010,,,,43967,44090,705,36667,3,36790,3
705,40440,3,41209,2,769,2010,2012,,,,44090,44859,705,36790,3,37559,2
705,41209,2,42366,2,1157,2012,2015,,,,44859,46016,705,37559,2,38716,2
706,39951,1,42366,1,2415,2009,2015,,,,43601,46016,706,36301,1,38716,1
707,42244,5,42366,5,122,2015,2015,,,,45894,46016,707,38594,5,38716,5
708,39951,2,42366,2,2415,2009,2015,,,,43601,46016,708,36301,2,38716,2
709,39951,2,42366,2,2415,2009,2015,,,,43601,46016,709,36301,2,38716,2
710,41172,3,41179,2,7,2012,2012,,,,44822,44829,710,37522,3,37529,2
710,41179,2,42366,2,1187,2012,2015,,,,44829,46016,710,37529,2,38716,2
711,40510,4,41047,4,537,2010,2012,,,,44160,44697,711,36860,4,37397,4
711,41047,4,42366,4,1319,2012,2015,,,,44697,46016,711,37397,4,38716,4
712,40540,5,40713,5,173,2010,2011,,,,44190,44363,712,36890,5,37063,5
712,40713,5,42001,4,1288,2011,2014,,,,44363,45651,712,37063,5,38351,4
712,42001,4,42366,4,365,2014,2015,,,,45651,46016,712,38351,4,38716,4
713,39951,4,40440,5,489,2009,2010,,,,43601,44090,713,36301,4,36790,5
714,41415,6,42366,6,951,2013,2015,,,,45065,46016,714,37765,6,38716,6
715,40510,2,41412,2,902,2010,2013,,,,44160,45062,715,36860,2,37762,2
715,41412,2,42366,2,954,2013,2015,,,,45062,46016,715,37762,2,38716,2
716,40174,6,40691,5,517,2009,2011,,,,43824,44341,716,36524,6,37041,5
716,40691,5,40905,6,214,2011,2011,,,,44341,44555,716,37041,5,37255,6
716,40905,6,41148,6,243,2011,2012,,,,44555,44798,716,37255,6,37498,6
716,41148,6,42366,6,1218,2012,2015,,,,44798,46016,716,37498,6,38716,6
717,40540,3,40691,4,151,2010,2011,,,,44190,44341,717,36890,3,37041,4
717,40691,4,42366,4,1675,2011,2015,,,,44341,46016,717,37041,4,38716,4
718,41421,4,42366,4,945,2013,2015,,,,45071,46016,718,37771,4,38716,4
719,41270,2,42366,2,1096,2012,2015,,,,44920,46016,719,37620,2,38716,2
720,40479,5,41787,4,1308,2010,2014,,,,44129,45437,720,36829,5,38137,4
720,41787,4,42213,3,426,2014,2015,,,,45437,45863,720,38137,4,38563,3
720,42213,3,42366,3,153,2015,2015,,,,45863,46016,720,38563,3,38716,3
721,40174,5,40440,6,266,2009,2010,,,,43824,44090,721,36524,5,36790,6
721,40440,6,40540,5,100,2010,2010,,,,44090,44190,721,36790,6,36890,5
721,40540,5,40774,5,234,2010,2011,,,,44190,44424,721,36890,5,37124,5
721,40774,5,41901,6,1127,2011,2014,,,,44424,45551,721,37124,5,38251,6
722,41535,6,41635,6,100,2013,2013,,,,45185,45285,722,37885,6,37985,6
722,41635,6,41778,6,143,2013,2014,,,,45285,45428,722,37985,6,38128,6
722,41778,6,42366,6,588,2014,2015,,,,45428,46016,722,38128,6,38716,6
724,40540,4,41504,6,964,2010,2013,,,,44190,45154,724,36890,4,37854,6
724,41504,6,42366,6,862,2013,2015,,,,45154,46016,724,37854,6,38716,6
726,41635,4,42366,4,731,2013,2015,,,,45285,46016,726,37985,4,38716,4
728,40174,6,42366,6,2192,2009,2015,,,,43824,46016,728,36524,6,38716,6
729,40317,4,42366,4,2049,2010,2015,,,,43967,46016,729,36667,4,38716,4
730,40540,3,40905,2,365,2010,2011,,,,44190,44555,730,36890,3,37255,2
730,40905,2,42366,2,1461,2011,2015,,,,44555,46016,730,37255,2,38716,2
732,42143,3,42366,3,223,2015,2015,,,,45793,46016,732,38493,3,38716,3
733,40144,2,40682,2,538,2009,2011,,,,43794,44332,733,36494,2,37032,2
733,40682,2,41056,2,374,2011,2012,,,,44332,44706,733,37032,2,37406,2
733,41056,2,41635,3,579,2012,2013,,,,44706,45285,733,37406,2,37985,3
733,41635,3,42366,3,731,2013,2015,,,,45285,46016,733,37985,3,38716,3
734,40805,3,40905,3,100,2011,2011,,,,44455,44555,734,37155,3,37255,3
734,40905,3,41148,4,243,2011,2012,,,,44555,44798,734,37255,3,37498,4
735,40021,3,41412,4,1391,2009,2013,,,,43671,45062,735,36371,3,37762,4
735,41412,4,41574,4,162,2013,2013,,,,45062,45224,735,37762,4,37924,4
735,41574,4,42001,5,427,2013,2014,,,,45224,45651,735,37924,4,38351,5
735,42001,5,42366,5,365,2014,2015,,,,45651,46016,735,38351,5,38716,5
736,41421,4,42366,4,945,2013,2015,,,,45071,46016,736,37771,4,38716,4
738,41111,5,41139,4,28,2012,2012,,,,44761,44789,738,37461,5,37489,4
738,41139,4,42366,4,1227,2012,2015,,,,44789,46016,738,37489,4,38716,4
739,40682,6,41418,6,736,2011,2013,,,,44332,45068,739,37032,6,37768,6
739,41418,6,42152,7,734,2013,2015,,,,45068,45802,739,37768,6,38502,7
739,42152,7,42244,7,92,2015,2015,,,,45802,45894,739,38502,7,38594,7
739,42244,7,42366,7,122,2015,2015,,,,45894,46016,739,38594,7,38716,7
741,40326,7,40540,6,214,2010,2010,,,,43976,44190,741,36676,7,36890,6
741,40540,6,41270,6,730,2010,2012,,,,44190,44920,741,36890,6,37620,6
741,41270,6,41412,7,142,2012,2013,,,,44920,45062,741,37620,6,37762,7
742,41412,6,41635,6,223,2013,2013,,,,45062,45285,742,37762,6,37985,6
742,41635,6,42366,6,731,2013,2015,,,,45285,46016,742,37985,6,38716,6
743,40840,3,41117,4,277,2011,2012,,,,44490,44767,743,37190,3,37467,4
743,41117,4,41635,4,518,2012,2013,,,,44767,45285,743,37467,4,37985,4
743,41635,4,42145,5,510,2013,2015,,,,45285,45795,743,37985,4,38495,5
743,42145,5,42366,5,221,2015,2015,,,,45795,46016,743,38495,5,38716,5
745,40174,7,40348,7,174,2009,2010,,,,43824,43998,745,36524,7,36698,7
747,40174,3,42366,3,2192,2009,2015,,,,43824,46016,747,36524,3,38716,3
750,40083,5,40174,5,91,2009,2009,,,,43733,43824,750,36433,5,36524,5
750,40174,5,40510,5,336,2009,2010,,,,43824,44160,750,36524,5,36860,5
750,40510,5,41778,4,1268,2010,2014,,,,44160,45428,750,36860,5,38128,4
750,41778,4,42366,4,588,2014,2015,,,,45428,46016,750,38128,4,38716,4
751,39960,4,41170,4,1210,2009,2012,,,,43610,44820,751,36310,4,37520,4
751,41170,4,42366,5,1196,2012,2015,,,,44820,46016,751,37520,4,38716,5
751,41170,5,41544,6,374,2012,2013,,,,44820,45194,751,37520,5,37894,6
751,41544,6,42366,6,822,2013,2015,,,,45194,46016,751,37894,6,38716,6
752,41139,2,42366,2,1227,2012,2015,,,,44789,46016,752,37489,2,38716,2
753,40317,4,42366,4,2049,2010,2015,,,,43967,46016,753,36667,4,38716,4
754,40326,6,42366,6,2040,2010,2015,,,,43976,46016,754,36676,6,38716,6
755,41270,7,42366,7,1096,2012,2015,,,,44920,46016,755,37620,7,38716,7
756,40783,5,41047,4,264,2011,2012,,,,44433,44697,756,37133,5,37397,4
756,41047,4,41931,4,884,2012,2014,,,,44697,45581,756,37397,4,38281,4
756,41931,4,42366,4,435,2014,2015,,,,45581,46016,756,38281,4,38716,4
759,40174,5,42366,5,2192,2009,2015,,,,43824,46016,759,36524,5,38716,5
760,41787,3,42366,3,579,2014,2015,,,,45437,46016,760,38137,3,38716,3
761,41047,3,42366,3,1319,2012,2015,,,,44697,46016,761,37397,3,38716,3
763,40682,4,42366,4,1684,2011,2015,,,,44332,46016,763,37032,4,38716,4
765,41056,3,41635,3,579,2012,2013,,,,44706,45285,765,37406,3,37985,3
765,41635,3,42366,3,731,2013,2015,,,,45285,46016,765,37985,3,38716,3
767,40174,2,42366,2,2192,2009,2015,,,,43824,46016,767,36524,2,38716,2
769,40682,2,41635,3,953,2011,2013,,,,44332,45285,769,37032,2,37985,3
770,40682,5,41270,6,588,2011,2012,,,,44332,44920,770,37032,5,37620,6
770,41605,6,42366,6,761,2013,2015,,,,45255,46016,770,37955,6,38716,6
771,40174,6,41574,6,1400,2009,2013,,,,43824,45224,771,36524,6,37924,6
771,41574,6,41635,7,61,2013,2013,,,,45224,45285,771,37924,6,37985,7
771,41635,7,42366,7,731,2013,2015,,,,45285,46016,771,37985,7,38716,7
772,40866,8,40905,7,39,2011,2011,,,,44516,44555,772,37216,8,37255,7
772,41635,6,42001,6,366,2013,2014,,,,45285,45651,772,37985,6,38351,6
772,42001,6,42143,7,142,2014,2015,,,,45651,45793,772,38351,6,38493,7
772,42143,7,42366,7,223,2015,2015,,,,45793,46016,772,38493,7,38716,7
774,40540,2,42366,2,1826,2010,2015,,,,44190,46016,774,36890,2,38716,2
776,40905,2,42366,2,1461,2011,2015,,,,44555,46016,776,37255,2,38716,2
776,40905,2,41054,3,149,2011,2012,,,,44555,44704,776,37255,2,37404,3
776,41054,3,42366,3,1312,2012,2015,,,,44704,46016,776,37404,3,38716,3
777,40722,4,41047,5,325,2011,2012,,,,44372,44697,777,37072,4,37397,5
777,41047,5,41270,5,223,2012,2012,,,,44697,44920,777,37397,5,37620,5
777,41270,5,42366,5,1096,2012,2015,,,,44920,46016,777,37620,5,38716,5
778,40144,5,42366,6,2222,2009,2015,,,,43794,46016,778,36494,5,38716,6
778,40144,6,40844,6,700,2009,2011,,,,43794,44494,778,36494,6,37194,6
778,40844,6,41635,6,791,2011,2013,,,,44494,45285,778,37194,6,37985,6
778,41635,6,42366,6,731,2013,2015,,,,45285,46016,778,37985,6,38716,6
779,41270,4,42366,4,1096,2012,2015,,,,44920,46016,779,37620,4,38716,4
780,40317,2,41047,1,730,2010,2012,,,,43967,44697,780,36667,2,37397,1
780,41047,1,42366,1,1319,2012,2015,,,,44697,46016,780,37397,1,38716,1
781,40317,2,41047,1,730,2010,2012,,,,43967,44697,781,36667,2,37397,1
781,41047,1,42366,1,1319,2012,2015,,,,44697,46016,781,37397,1,38716,1
782,40317,5,40326,6,9,2010,2010,,,,43967,43976,782,36667,5,36676,6
782,40326,6,40353,6,27,2010,2010,,,,43976,44003,782,36676,6,36703,6
782,40353,6,41047,7,694,2010,2012,,,,44003,44697,782,36703,6,37397,7
783,40378,6,40540,5,162,2010,2010,,,,44028,44190,783,36728,6,36890,5
783,40540,5,40682,6,142,2010,2011,,,,44190,44332,783,36890,5,37032,6
783,40682,6,42366,7,1684,2011,2015,,,,44332,46016,783,37032,6,38716,7
783,40682,7,40721,7,39,2011,2011,,,,44332,44371,783,37032,7,37071,7
784,40320,3,40479,4,159,2010,2010,,,,43970,44129,784,36670,3,36829,4
784,40479,4,40713,4,234,2010,2011,,,,44129,44363,784,36829,4,37063,4
784,40713,4,42366,4,1653,2011,2015,,,,44363,46016,784,37063,4,38716,4
785,40104,4,42366,4,2262,2009,2015,,,,43754,46016,785,36454,4,38716,4
786,40682,4,40844,4,162,2011,2011,,,,44332,44494,786,37032,4,37194,4
786,40844,4,42366,5,1522,2011,2015,,,,44494,46016,786,37194,4,38716,5
786,42366,5,42366,5,0,2015,2015,,,,46016,46016,786,38716,5,38716,5
787,39951,3,40814,4,863,2009,2011,,,,43601,44464,787,36301,3,37164,4
787,40814,4,41047,4,233,2011,2012,,,,44464,44697,787,37164,4,37397,4
787,41047,4,41270,5,223,2012,2012,,,,44697,44920,787,37397,4,37620,5
787,41270,5,41473,5,203,2012,2013,,,,44920,45123,787,37620,5,37823,5
787,41473,5,42366,5,893,2013,2015,,,,45123,46016,787,37823,5,38716,5
788,39951,3,40540,2,589,2009,2010,,,,43601,44190,788,36301,3,36890,2
788,40540,2,41047,2,507,2010,2012,,,,44190,44697,788,36890,2,37397,2
788,41047,2,42366,2,1319,2012,2015,,,,44697,46016,788,37397,2,38716,2
789,41056,2,42366,2,1310,2012,2015,,,,44706,46016,789,37406,2,38716,2
791,39960,3,40540,3,580,2009,2010,,,,43610,44190,791,36310,3,36890,3
791,40540,3,40844,3,304,2010,2011,,,,44190,44494,791,36890,3,37194,3
791,40844,3,42366,3,1522,2011,2015,,,,44494,46016,791,37194,3,38716,3
793,40174,2,40905,2,731,2009,2011,,,,43824,44555,793,36524,2,37255,2
793,40905,2,42366,2,1461,2011,2015,,,,44555,46016,793,37255,2,38716,2
794,40174,3,42366,3,2192,2009,2015,,,,43824,46016,794,36524,3,38716,3
795,41270,2,42275,2,1005,2012,2015,,,,44920,45925,795,37620,2,38625,2
795,42275,2,42366,2,91,2015,2015,,,,45925,46016,795,38625,2,38716,2
796,41270,2,42213,2,943,2012,2015,,,,44920,45863,796,37620,2,38563,2
796,42213,2,42366,2,153,2015,2015,,,,45863,46016,796,38563,2,38716,2
797,40144,7,40174,7,30,2009,2009,,,,43794,43824,797,36494,7,36524,7
798,40317,2,42366,2,2049,2010,2015,,,,43967,46016,798,36667,2,38716,2
799,40144,3,41839,3,1695,2009,2014,,,,43794,45489,799,36494,3,38189,3
799,41839,3,42366,3,527,2014,2015,,,,45489,46016,799,38189,3,38716,3
800,41778,4,42366,4,588,2014,2015,,,,45428,46016,800,38128,4,38716,4
802,40052,3,42366,3,2314,2009,2015,,,,43702,46016,802,36402,3,38716,3
805,41421,3,42366,3,945,2013,2015,,,,45071,46016,805,37771,3,38716,3
806,40905,2,41778,2,873,2011,2014,,,,44555,45428,806,37255,2,38128,2
806,41778,2,42366,2,588,2014,2015,,,,45428,46016,806,38128,2,38716,2
807,40326,2,41270,2,944,2010,2012,,,,43976,44920,807,36676,2,37620,2
807,41270,2,42143,2,873,2012,2015,,,,44920,45793,807,37620,2,38493,2
807,42143,2,42366,2,223,2015,2015,,,,45793,46016,807,38493,2,38716,2
809,41270,2,42305,2,1035,2012,2015,,,,44920,45955,809,37620,2,38655,2
809,42305,2,42366,2,61,2015,2015,,,,45955,46016,809,38655,2,38716,2
810,41778,2,42366,2,588,2014,2015,,,,45428,46016,810,38128,2,38716,2
811,40326,3,41049,2,723,2010,2012,,,,43976,44699,811,36676,3,37399,2
813,41140,2,42366,2,1226,2012,2015,,,,44790,46016,813,37490,2,38716,2
815,40174,3,41412,2,1238,2009,2013,,,,43824,45062,815,36524,3,37762,2
815,41412,2,42366,2,954,2013,2015,,,,45062,46016,815,37762,2,38716,2
816,40540,2,41421,1,881,2010,2013,,,,44190,45071,816,36890,2,37771,1
816,41421,1,42366,1,945,2013,2015,,,,45071,46016,816,37771,1,38716,1
817,40326,3,42366,3,2040,2010,2015,,,,43976,46016,817,36676,3,38716,3
818,40691,2,40905,2,214,2011,2011,,,,44341,44555,818,37041,2,37255,2
819,41139,2,42366,2,1227,2012,2015,,,,44789,46016,819,37489,2,38716,2
820,41231,2,42366,2,1135,2012,2015,,,,44881,46016,820,37581,2,38716,2
821,39951,6,42366,6,2415,2009,2015,,,,43601,46016,821,36301,6,38716,6
822,40409,3,41270,2,861,2010,2012,,,,44059,44920,822,36759,3,37620,2
824,40326,3,41270,2,944,2010,2012,,,,43976,44920,824,36676,3,37620,2
824,41270,2,42366,2,1096,2012,2015,,,,44920,46016,824,37620,2,38716,2
825,40326,5,40835,6,509,2010,2011,,,,43976,44485,825,36676,5,37185,6
825,40835,6,40844,6,9,2011,2011,,,,44485,44494,825,37185,6,37194,6
825,40844,6,42366,6,1522,2011,2015,,,,44494,46016,825,37194,6,38716,6
826,40682,5,41270,6,588,2011,2012,,,,44332,44920,826,37032,5,37620,6
826,41605,7,42366,7,761,2013,2015,,,,45255,46016,826,37955,7,38716,7
826,41605,7,42366,7,761,2013,2015,,,,45255,46016,826,37955,7,38716,7
827,40470,3,42275,3,1805,2010,2015,,,,44120,45925,827,36820,3,38625,3
827,42275,3,42366,3,91,2015,2015,,,,45925,46016,827,38625,3,38716,3
828,40905,4,42366,4,1461,2011,2015,,,,44555,46016,828,37255,4,38716,4
830,40409,4,41139,5,730,2010,2012,,,,44059,44789,830,36759,4,37489,5
830,41139,5,41170,5,31,2012,2012,,,,44789,44820,830,37489,5,37520,5
830,41170,5,41421,6,251,2012,2013,,,,44820,45071,830,37520,5,37771,6
830,41421,6,42366,6,945,2013,2015,,,,45071,46016,830,37771,6,38716,6
831,40317,3,41056,3,739,2010,2012,,,,43967,44706,831,36667,3,37406,3
831,41056,3,42366,3,1310,2012,2015,,,,44706,46016,831,37406,3,38716,3
832,40043,5,42366,5,2323,2009,2015,,,,43693,46016,832,36393,5,38716,5
833,41047,4,41056,4,9,2012,2012,,,,44697,44706,833,37397,4,37406,4
833,41056,4,41270,5,214,2012,2012,,,,44706,44920,833,37406,4,37620,5
833,41270,5,41412,6,142,2012,2013,,,,44920,45062,833,37620,5,37762,6
833,41412,6,41421,7,9,2013,2013,,,,45062,45071,833,37762,6,37771,7
834,40317,3,41047,3,730,2010,2012,,,,43967,44697,834,36667,3,37397,3
834,41047,3,42366,3,1319,2012,2015,,,,44697,46016,834,37397,3,38716,3
835,39951,4,42366,4,2415,2009,2015,,,,43601,46016,835,36301,4,38716,4
837,39986,4,40317,4,331,2009,2010,,,,43636,43967,837,36336,4,36667,4
837,40317,4,42143,4,1826,2010,2015,,,,43967,45793,837,36667,4,38493,4
837,42143,4,42366,4,223,2015,2015,,,,45793,46016,837,38493,4,38716,4
838,39982,6,40682,5,700,2009,2011,,,,43632,44332,838,36332,6,37032,5
838,40682,5,42366,5,1684,2011,2015,,,,44332,46016,838,37032,5,38716,5
839,39982,3,40682,3,700,2009,2011,,,,43632,44332,839,36332,3,37032,3
839,40682,3,40691,3,9,2011,2011,,,,44332,44341,839,37032,3,37041,3
839,40691,3,41047,4,356,2011,2012,,,,44341,44697,839,37041,3,37397,4
839,41047,4,41635,4,588,2012,2013,,,,44697,45285,839,37397,4,37985,4
840,39960,4,40479,5,519,2009,2010,,,,43610,44129,840,36310,4,36829,5
840,40479,5,40536,6,57,2010,2010,,,,44129,44186,840,36829,5,36886,6
840,40536,6,40540,5,4,2010,2010,,,,44186,44190,840,36886,6,36890,5
840,40540,5,41270,7,730,2010,2012,,,,44190,44920,840,36890,5,37620,7
840,41270,7,42366,7,1096,2012,2015,,,,44920,46016,840,37620,7,38716,7
841,40722,5,40905,5,183,2011,2011,,,,44372,44555,841,37072,5,37255,5
841,40905,5,41170,6,265,2011,2012,,,,44555,44820,841,37255,5,37520,6
841,41170,6,42143,5,973,2012,2015,,,,44820,45793,841,37520,6,38493,5
841,42143,5,42366,5,223,2015,2015,,,,45793,46016,841,38493,5,38716,5
842,41931,3,42366,3,435,2014,2015,,,,45581,46016,842,38281,3,38716,3
843,41270,3,42001,2,731,2012,2014,,,,44920,45651,843,37620,3,38351,2
843,42001,2,42366,2,365,2014,2015,,,,45651,46016,843,38351,2,38716,2
844,40722,3,41421,4,699,2011,2013,,,,44372,45071,844,37072,3,37771,4
844,41421,4,42001,4,580,2013,2014,,,,45071,45651,844,37771,4,38351,4
844,42001,4,42366,4,365,2014,2015,,,,45651,46016,844,38351,4,38716,4
845,41056,3,42366,3,1310,2012,2015,,,,44706,46016,845,37406,3,38716,3
846,41056,4,42366,4,1310,2012,2015,,,,44706,46016,846,37406,4,38716,4
847,40317,3,41270,4,953,2010,2012,,,,43967,44920,847,36667,3,37620,4
848,40540,3,41270,3,730,2010,2012,,,,44190,44920,848,36890,3,37620,3
849,40418,2,41056,3,638,2010,2012,,,,44068,44706,849,36768,2,37406,3
849,41056,3,42366,3,1310,2012,2015,,,,44706,46016,849,37406,3,38716,3
850,40479,2,41270,3,791,2010,2012,,,,44129,44920,850,36829,2,37620,3
850,41270,3,42366,3,1096,2012,2015,,,,44920,46016,850,37620,3,38716,3
851,40540,2,41270,3,730,2010,2012,,,,44190,44920,851,36890,2,37620,3
851,41270,3,41931,3,661,2012,2014,,,,44920,45581,851,37620,3,38281,3
851,41931,3,42366,3,435,2014,2015,,,,45581,46016,851,38281,3,38716,3
852,41047,4,41270,4,223,2012,2012,,,,44697,44920,852,37397,4,37620,4
852,41270,4,42366,4,1096,2012,2015,,,,44920,46016,852,37620,4,38716,4
853,40691,3,42366,3,1675,2011,2015,,,,44341,46016,853,37041,3,38716,3
854,40905,4,41047,5,142,2011,2012,,,,44555,44697,854,37255,4,37397,5
854,41047,5,41056,5,9,2012,2012,,,,44697,44706,854,37397,5,37406,5
854,41056,5,41787,5,731,2012,2014,,,,44706,45437,854,37406,5,38137,5
854,41787,5,41901,5,114,2014,2014,,,,45437,45551,854,38137,5,38251,5
854,41901,5,42152,4,251,2014,2015,,,,45551,45802,854,38251,5,38502,4
854,42152,4,42366,4,214,2015,2015,,,,45802,46016,854,38502,4,38716,4
856,40540,2,41270,2,730,2010,2012,,,,44190,44920,856,36890,2,37620,2
856,41270,2,42366,2,1096,2012,2015,,,,44920,46016,856,37620,2,38716,2
857,40174,5,42275,5,2101,2009,2015,,,,43824,45925,857,36524,5,38625,5
857,42275,5,42366,5,91,2015,2015,,,,45925,46016,857,38625,5,38716,5
858,41056,3,42366,3,1310,2012,2015,,,,44706,46016,858,37406,3,38716,3
860,40875,4,41047,4,172,2011,2012,,,,44525,44697,860,37225,4,37397,4
860,41047,4,42366,4,1319,2012,2015,,,,44697,46016,860,37397,4,38716,4
863,40414,3,41412,3,998,2010,2013,,,,44064,45062,863,36764,3,37762,3
863,41412,3,42366,3,954,2013,2015,,,,45062,46016,863,37762,3,38716,3
864,40540,3,41270,4,730,2010,2012,,,,44190,44920,864,36890,3,37620,4
864,41270,4,42366,4,1096,2012,2015,,,,44920,46016,864,37620,4,38716,4
865,41962,4,42144,4,182,2014,2015,,,,45612,45794,865,38312,4,38494,4
865,42144,4,42366,4,222,2015,2015,,,,45794,46016,865,38494,4,38716,4
866,41412,3,42001,4,589,2013,2014,,,,45062,45651,866,37762,3,38351,4
866,42001,4,42366,4,365,2014,2015,,,,45651,46016,866,38351,4,38716,4
866,42366,4,42366,4,0,2015,2015,,,,46016,46016,866,38716,4,38716,4
868,41848,4,42336,4,488,2014,2015,,,,45498,45986,868,38198,4,38686,4
868,42336,4,42366,4,30,2015,2015,,,,45986,46016,868,38686,4,38716,4
869,41412,3,42001,4,589,2013,2014,,,,45062,45651,869,37762,3,38351,4
869,42001,4,42366,4,365,2014,2015,,,,45651,46016,869,38351,4,38716,4
870,40540,4,40905,4,365,2010,2011,,,,44190,44555,870,36890,4,37255,4
870,40905,4,41778,4,873,2011,2014,,,,44555,45428,870,37255,4,38128,4
870,41778,4,42366,4,588,2014,2015,,,,45428,46016,870,38128,4,38716,4
872,40540,2,41087,3,547,2010,2012,,,,44190,44737,872,36890,2,37437,3
872,41087,3,42366,3,1279,2012,2015,,,,44737,46016,872,37437,3,38716,3
873,40540,3,41270,3,730,2010,2012,,,,44190,44920,873,36890,3,37620,3
873,41270,3,42366,3,1096,2012,2015,,,,44920,46016,873,37620,3,38716,3
874,40326,2,41270,3,944,2010,2012,,,,43976,44920,874,36676,2,37620,3
876,40540,2,41270,3,730,2010,2012,,,,44190,44920,876,36890,2,37620,3
877,41574,4,41778,4,204,2013,2014,,,,45224,45428,877,37924,4,38128,4
877,41778,4,42366,4,588,2014,2015,,,,45428,46016,877,38128,4,38716,4
878,40348,2,41270,3,922,2010,2012,,,,43998,44920,878,36698,2,37620,3
879,40844,3,42366,3,1522,2011,2015,,,,44494,46016,879,37194,3,38716,3
880,40317,2,41270,3,953,2010,2012,,,,43967,44920,880,36667,2,37620,3
881,42143,2,42366,2,223,2015,2015,,,,45793,46016,881,38493,2,38716,2
882,40317,2,41170,3,853,2010,2012,,,,43967,44820,882,36667,2,37520,3
883,40479,2,41270,3,791,2010,2012,,,,44129,44920,883,36829,2,37620,3
885,40174,3,42366,3,2192,2009,2015,,,,43824,46016,885,36524,3,38716,3
887,40174,5,41047,5,873,2009,2012,,,,43824,44697,887,36524,5,37397,5
887,41047,5,41931,6,884,2012,2014,,,,44697,45581,887,37397,5,38281,6
887,41931,6,42366,6,435,2014,2015,,,,45581,46016,887,38281,6,38716,6
888,41047,2,41270,3,223,2012,2012,,,,44697,44920,888,37397,2,37620,3
888,41270,3,41565,2,295,2012,2013,,,,44920,45215,888,37620,3,37915,2
888,41565,2,42366,2,801,2013,2015,,,,45215,46016,888,37915,2,38716,2
889,40165,5,40783,6,618,2009,2011,,,,43815,44433,889,36515,5,37133,6
889,40783,6,42366,6,1583,2011,2015,,,,44433,46016,889,37133,6,38716,6
891,40540,4,41056,5,516,2010,2012,,,,44190,44706,891,36890,4,37406,5
891,41056,5,41412,5,356,2012,2013,,,,44706,45062,891,37406,5,37762,5
891,41412,5,42366,5,954,2013,2015,,,,45062,46016,891,37762,5,38716,5
893,39960,4,41270,5,1310,2009,2012,,,,43610,44920,893,36310,4,37620,5
893,41270,5,42366,5,1096,2012,2015,,,,44920,46016,893,37620,5,38716,5
895,40905,4,42366,4,1461,2011,2015,,,,44555,46016,895,37255,4,38716,4
897,39951,4,39960,3,9,2009,2009,,,,43601,43610,897,36301,4,36310,3
897,39960,3,39982,5,22,2009,2009,,,,43610,43632,897,36310,3,36332,5
897,39982,5,40174,6,192,2009,2009,,,,43632,43824,897,36332,5,36524,6
897,40174,6,40326,2,152,2009,2010,,,,43824,43976,897,36524,6,36676,2
897,40326,2,42366,2,2040,2010,2015,,,,43976,46016,897,36676,2,38716,2
898,41270,3,42366,3,1096,2012,2015,,,,44920,46016,898,37620,3,38716,3
899,41421,5,41452,6,31,2013,2013,,,,45071,45102,899,37771,5,37802,6
899,41452,6,41605,6,153,2013,2013,,,,45102,45255,899,37802,6,37955,6
899,41605,6,41778,6,173,2013,2014,,,,45255,45428,899,37955,6,38128,6
899,41778,6,42366,6,588,2014,2015,,,,45428,46016,899,38128,6,38716,6
900,40174,2,40905,2,731,2009,2011,,,,43824,44555,900,36524,2,37255,2
900,40905,2,42366,2,1461,2011,2015,,,,44555,46016,900,37255,2,38716,2
902,40743,2,42366,2,1623,2011,2015,,,,44393,46016,902,37093,2,38716,2
903,40540,3,41544,3,1004,2010,2013,,,,44190,45194,903,36890,3,37894,3
903,41544,3,42366,3,822,2013,2015,,,,45194,46016,903,37894,3,38716,3
906,40540,5,40752,6,212,2010,2011,,,,44190,44402,906,36890,5,37102,6
906,40752,6,41208,6,456,2011,2012,,,,44402,44858,906,37102,6,37558,6
906,41208,6,42001,7,793,2012,2014,,,,44858,45651,906,37558,6,38351,7
906,42001,7,42366,7,365,2014,2015,,,,45651,46016,906,38351,7,38716,7
907,40326,3,42143,3,1817,2010,2015,,,,43976,45793,907,36676,3,38493,3
907,42143,3,42366,3,223,2015,2015,,,,45793,46016,907,38493,3,38716,3
908,39982,3,41535,3,1553,2009,2013,,,,43632,45185,908,36332,3,37885,3
908,41535,3,42366,3,831,2013,2015,,,,45185,46016,908,37885,3,38716,3
911,39960,3,41270,3,1310,2009,2012,,,,43610,44920,911,36310,3,37620,3
911,41270,3,42366,3,1096,2012,2015,,,,44920,46016,911,37620,3,38716,3
912,40783,4,41209,4,426,2011,2012,,,,44433,44859,912,37133,4,37559,4
912,41209,4,42366,4,1157,2012,2015,,,,44859,46016,912,37559,4,38716,4
913,40021,4,40449,5,428,2009,2010,,,,43671,44099,913,36371,4,36799,5
913,40449,5,40540,5,91,2010,2010,,,,44099,44190,913,36799,5,36890,5
913,40540,5,41047,7,507,2010,2012,,,,44190,44697,913,36890,5,37397,7
913,41047,7,41056,6,9,2012,2012,,,,44697,44706,913,37397,7,37406,6
913,41056,6,41270,7,214,2012,2012,,,,44706,44920,913,37406,6,37620,7
914,42001,5,42366,5,365,2014,2015,,,,45651,46016,914,38351,5,38716,5
915,39960,7,40083,8,123,2009,2009,,,,43610,43733,915,36310,7,36433,8
915,40083,8,42366,8,2283,2009,2015,,,,43733,46016,915,36433,8,38716,8
916,40844,3,40905,4,61,2011,2011,,,,44494,44555,916,37194,3,37255,4
916,40905,4,41047,4,142,2011,2012,,,,44555,44697,916,37255,4,37397,4
916,41047,4,41270,5,223,2012,2012,,,,44697,44920,916,37397,4,37620,5
917,40326,7,40418,4,92,2010,2010,,,,43976,44068,917,36676,7,36768,4
917,40418,4,40470,6,52,2010,2010,,,,44068,44120,917,36768,4,36820,6
917,40470,6,40540,5,70,2010,2010,,,,44120,44190,917,36820,6,36890,5
917,40540,5,42366,6,1826,2010,2015,,,,44190,46016,917,36890,5,38716,6
917,40540,6,40783,7,243,2010,2011,,,,44190,44433,917,36890,6,37133,7
918,40052,5,40317,6,265,2009,2010,,,,43702,43967,918,36402,5,36667,6
918,40317,6,40324,6,7,2010,2010,,,,43967,43974,918,36667,6,36674,6
918,40324,6,40326,7,2,2010,2010,,,,43974,43976,918,36674,6,36676,7
920,40348,2,41270,3,922,2010,2012,,,,43998,44920,920,36698,2,37620,3
920,41270,3,42366,3,1096,2012,2015,,,,44920,46016,920,37620,3,38716,3
921,42305,3,42366,3,61,2015,2015,,,,45955,46016,921,38655,3,38716,3
922,41565,3,42366,3,801,2013,2015,,,,45215,46016,922,37915,3,38716,3
923,40317,4,40357,3,40,2010,2010,,,,43967,44007,923,36667,4,36707,3
925,40540,4,40875,4,335,2010,2011,,,,44190,44525,925,36890,4,37225,4
925,40875,4,41270,3,395,2011,2012,,,,44525,44920,925,37225,4,37620,3
925,41270,3,42366,3,1096,2012,2015,,,,44920,46016,925,37620,3,38716,3
926,40326,2,40905,2,579,2010,2011,,,,43976,44555,926,36676,2,37255,2
926,40905,2,41412,3,507,2011,2013,,,,44555,45062,926,37255,2,37762,3
926,41412,3,42366,3,954,2013,2015,,,,45062,46016,926,37762,3,38716,3
927,40317,4,40691,6,374,2010,2011,,,,43967,44341,927,36667,4,37041,6
927,40691,6,40866,8,175,2011,2011,,,,44341,44516,927,37041,6,37216,8
927,40866,8,40905,4,39,2011,2011,,,,44516,44555,927,37216,8,37255,4
927,40905,4,42366,4,1461,2011,2015,,,,44555,46016,927,37255,4,38716,4
929,40113,2,40691,3,578,2009,2011,,,,43763,44341,929,36463,2,37041,3
929,40691,3,40722,3,31,2011,2011,,,,44341,44372,929,37041,3,37072,3
929,40722,3,41056,4,334,2011,2012,,,,44372,44706,929,37072,3,37406,4
929,41056,4,42366,4,1310,2012,2015,,,,44706,46016,929,37406,4,38716,4
930,41179,4,41421,6,242,2012,2013,,,,44829,45071,930,37529,4,37771,6
930,41421,6,41544,5,123,2013,2013,,,,45071,45194,930,37771,6,37894,5
930,41544,5,42366,5,822,2013,2015,,,,45194,46016,930,37894,5,38716,5
932,41605,2,42366,2,761,2013,2015,,,,45255,46016,932,37955,2,38716,2
933,39991,4,40783,4,792,2009,2011,,,,43641,44433,933,36341,4,37133,4
933,40783,4,42366,4,1583,2011,2015,,,,44433,46016,933,37133,4,38716,4
934,39956,6,40835,7,879,2009,2011,,,,43606,44485,934,36306,6,37185,7
935,40540,4,42366,4,1826,2010,2015,,,,44190,46016,935,36890,4,38716,4
935,40540,4,40682,5,142,2010,2011,,,,44190,44332,935,36890,4,37032,5
935,40682,5,41910,4,1228,2011,2014,,,,44332,45560,935,37032,5,38260,4
935,41910,4,42366,4,456,2014,2015,,,,45560,46016,935,38260,4,38716,4
937,40540,4,40691,4,151,2010,2011,,,,44190,44341,937,36890,4,37041,4
937,40691,4,42143,3,1452,2011,2015,,,,44341,45793,937,37041,4,38493,3
937,42143,3,42366,3,223,2015,2015,,,,45793,46016,937,38493,3,38716,3
938,41412,3,42366,3,954,2013,2015,,,,45062,46016,938,37762,3,38716,3
939,40540,4,42366,4,1826,2010,2015,,,,44190,46016,939,36890,4,38716,4
940,40317,7,42366,8,2049,2010,2015,,,,43967,46016,940,36667,7,38716,8
940,40317,8,40326,6,9,2010,2010,,,,43967,43976,940,36667,8,36676,6
941,41848,4,42366,4,518,2014,2015,,,,45498,46016,941,38198,4,38716,4
943,40174,4,42366,4,2192,2009,2015,,,,43824,46016,943,36524,4,38716,4
945,41117,3,42366,3,1249,2012,2015,,,,44767,46016,945,37467,3,38716,3
946,40713,1,42366,1,1653,2011,2015,,,,44363,46016,946,37063,1,38716,1
947,40905,3,41780,3,875,2011,2014,,,,44555,45430,947,37255,3,38130,3
947,41780,3,42366,3,586,2014,2015,,,,45430,46016,947,38130,3,38716,3
948,40348,5,40540,5,192,2010,2010,,,,43998,44190,948,36698,5,36890,5
948,40540,5,42366,5,1826,2010,2015,,,,44190,46016,948,36890,5,38716,5
951,40905,4,41049,4,144,2011,2012,,,,44555,44699,951,37255,4,37399,4
951,41049,4,42366,4,1317,2012,2015,,,,44699,46016,951,37399,4,38716,4
952,40774,3,40905,2,131,2011,2011,,,,44424,44555,952,37124,3,37255,2
952,40905,2,41270,3,365,2011,2012,,,,44555,44920,952,37255,2,37620,3
952,41270,3,42366,3,1096,2012,2015,,,,44920,46016,952,37620,3,38716,3
953,40691,2,42366,3,1675,2011,2015,,,,44341,46016,953,37041,2,38716,3
953,40691,3,41047,3,356,2011,2012,,,,44341,44697,953,37041,3,37397,3
954,39960,4,40905,5,945,2009,2011,,,,43610,44555,954,36310,4,37255,5
954,40905,5,41870,4,965,2011,2014,,,,44555,45520,954,37255,5,38220,4
954,41870,4,42366,4,496,2014,2015,,,,45520,46016,954,38220,4,38716,4
955,39951,6,40317,6,366,2009,2010,,,,43601,43967,955,36301,6,36667,6
955,40317,6,40409,7,92,2010,2010,,,,43967,44059,955,36667,6,36759,7
955,40409,7,40682,8,273,2010,2011,,,,44059,44332,955,36759,7,37032,8
955,40682,8,40814,7,132,2011,2011,,,,44332,44464,955,37032,8,37164,7
955,40814,7,42366,7,1552,2011,2015,,,,44464,46016,955,37164,7,38716,7
956,39960,5,40174,6,214,2009,2009,,,,43610,43824,956,36310,5,36524,6
956,40174,6,40905,6,731,2009,2011,,,,43824,44555,956,36524,6,37255,6
956,40905,6,41056,7,151,2011,2012,,,,44555,44706,956,37255,6,37406,7
956,41056,7,42143,6,1087,2012,2015,,,,44706,45793,956,37406,7,38493,6
956,42143,6,42366,6,223,2015,2015,,,,45793,46016,956,38493,6,38716,6
957,42001,3,42366,3,365,2014,2015,,,,45651,46016,957,38351,3,38716,3
958,41482,4,42183,3,701,2013,2015,,,,45132,45833,958,37832,4,38533,3
958,42183,3,42366,3,183,2015,2015,,,,45833,46016,958,38533,3,38716,3
959,40021,3,42183,3,2162,2009,2015,,,,43671,45833,959,36371,3,38533,3
959,42183,3,42366,3,183,2015,2015,,,,45833,46016,959,38533,3,38716,3
961,39982,4,41778,5,1796,2009,2014,,,,43632,45428,961,36332,4,38128,5
961,41778,5,41971,6,193,2014,2014,,,,45428,45621,961,38128,5,38321,6
961,41971,6,42145,6,174,2014,2015,,,,45621,45795,961,38321,6,38495,6
961,42145,6,42366,6,221,2015,2015,,,,45795,46016,961,38495,6,38716,6
962,40052,4,42366,4,2314,2009,2015,,,,43702,46016,962,36402,4,38716,4
963,40540,6,41270,5,730,2010,2012,,,,44190,44920,963,36890,6,37620,5
963,41270,5,41473,5,203,2012,2013,,,,44920,45123,963,37620,5,37823,5
964,40174,7,40409,6,235,2009,2010,,,,43824,44059,964,36524,7,36759,6
964,40409,6,41421,6,1012,2010,2013,,,,44059,45071,964,36759,6,37771,6
964,41421,6,42366,6,945,2013,2015,,,,45071,46016,964,37771,6,38716,6
966,40174,4,42366,4,2192,2009,2015,,,,43824,46016,966,36524,4,38716,4
968,40814,3,41412,3,598,2011,2013,,,,44464,45062,968,37164,3,37762,3
968,41412,3,42366,3,954,2013,2015,,,,45062,46016,968,37762,3,38716,3
969,40174,3,40409,2,235,2009,2010,,,,43824,44059,969,36524,3,36759,2
969,40409,2,41635,3,1226,2010,2013,,,,44059,45285,969,36759,2,37985,3
969,41635,3,42366,3,731,2013,2015,,,,45285,46016,969,37985,3,38716,3
970,41445,3,42336,2,891,2013,2015,,,,45095,45986,970,37795,3,38686,2
970,42336,2,42366,2,30,2015,2015,,,,45986,46016,970,38686,2,38716,2
971,41504,5,41635,5,131,2013,2013,,,,45154,45285,971,37854,5,37985,5
971,41635,5,42366,5,731,2013,2015,,,,45285,46016,971,37985,5,38716,5
973,40691,4,41170,4,479,2011,2012,,,,44341,44820,973,37041,4,37520,4
973,41170,4,42366,4,1196,2012,2015,,,,44820,46016,973,37520,4,38716,4
974,40021,4,41047,4,1026,2009,2012,,,,43671,44697,974,36371,4,37397,4
974,41047,4,41078,5,31,2012,2012,,,,44697,44728,974,37397,4,37428,5
974,41452,6,41931,6,479,2013,2014,,,,45102,45581,974,37802,6,38281,6
974,41931,6,42366,6,435,2014,2015,,,,45581,46016,974,38281,6,38716,6
975,41565,3,42001,3,436,2013,2014,,,,45215,45651,975,37915,3,38351,3
975,42001,3,42366,3,365,2014,2015,,,,45651,46016,975,38351,3,38716,3
976,41635,3,42366,3,731,2013,2015,,,,45285,46016,976,37985,3,38716,3
977,41056,4,41078,4,22,2012,2012,,,,44706,44728,977,37406,4,37428,4
977,41078,4,41270,4,192,2012,2012,,,,44728,44920,977,37428,4,37620,4
977,41270,4,42366,4,1096,2012,2015,,,,44920,46016,977,37620,4,38716,4
978,40540,2,42366,2,1826,2010,2015,,,,44190,46016,978,36890,2,38716,2
979,41931,5,42366,5,435,2014,2015,,,,45581,46016,979,38281,5,38716,5
981,39951,4,39960,4,9,2009,2009,,,,43601,43610,981,36301,4,36310,4
981,39960,4,40326,3,366,2009,2010,,,,43610,43976,981,36310,4,36676,3
981,40326,3,41056,3,730,2010,2012,,,,43976,44706,981,36676,3,37406,3
981,41056,3,42366,3,1310,2012,2015,,,,44706,46016,981,37406,3,38716,3
982,40135,3,42152,3,2017,2009,2015,,,,43785,45802,982,36485,3,38502,3
982,42152,3,42366,3,214,2015,2015,,,,45802,46016,982,38502,3,38716,3
983,40814,4,42366,4,1552,2011,2015,,,,44464,46016,983,37164,4,38716,4
984,40691,3,42366,3,1675,2011,2015,,,,44341,46016,984,37041,3,38716,3
985,41148,3,41504,2,356,2012,2013,,,,44798,45154,985,37498,3,37854,2
985,41504,2,42366,2,862,2013,2015,,,,45154,46016,985,37854,2,38716,2
986,41108,2,41421,2,313,2012,2013,,,,44758,45071,986,37458,2,37771,2
986,41421,2,42366,2,945,2013,2015,,,,45071,46016,986,37771,2,38716,2
987,41848,2,42366,2,518,2014,2015,,,,45498,46016,987,38198,2,38716,2
988,40540,4,41504,4,964,2010,2013,,,,44190,45154,988,36890,4,37854,4
988,41504,4,42366,4,862,2013,2015,,,,45154,46016,988,37854,4,38716,4
990,39951,4,40317,3,366,2009,2010,,,,43601,43967,990,36301,4,36667,3
991,42143,3,42366,3,223,2015,2015,,,,45793,46016,991,38493,3,38716,3
992,39960,4,42366,4,2406,2009,2015,,,,43610,46016,992,36310,4,38716,4
993,41635,6,42366,6,731,2013,2015,,,,45285,46016,993,37985,6,38716,6
994,40348,4,41482,4,1134,2010,2013,,,,43998,45132,994,36698,4,37832,4
994,41482,4,42366,4,884,2013,2015,,,,45132,46016,994,37832,4,38716,4
995,40540,4,41565,4,1025,2010,2013,,,,44190,45215,995,36890,4,37915,4
995,41565,4,42366,4,801,2013,2015,,,,45215,46016,995,37915,4,38716,4
996,40317,2,42366,2,2049,2010,2015,,,,43967,46016,996,36667,2,38716,2
998,41785,2,42366,2,581,2014,2015,,,,45435,46016,998,38135,2,38716,2
1000,39951,3,42366,3,2415,2009,2015,,,,43601,46016,1000,36301,3,38716,3
1002,40326,5,41270,5,944,2010,2012,,,,43976,44920,1002,36676,5,37620,5
1002,41270,5,41412,7,142,2012,2013,,,,44920,45062,1002,37620,5,37762,7
1002,41412,7,41574,7,162,2013,2013,,,,45062,45224,1002,37762,7,37924,7
1003,41910,4,42366,4,456,2014,2015,,,,45560,46016,1003,38260,4,38716,4
1004,39960,6,40682,5,722,2009,2011,,,,43610,44332,1004,36310,6,37032,5
1004,40682,5,41047,6,365,2011,2012,,,,44332,44697,1004,37032,5,37397,6
1004,41047,6,42366,6,1319,2012,2015,,,,44697,46016,1004,37397,6,38716,6
1005,39960,2,41412,2,1452,2009,2013,,,,43610,45062,1005,36310,2,37762,2
1005,41412,2,41781,3,369,2013,2014,,,,45062,45431,1005,37762,2,38131,3
1005,41781,3,41785,3,4,2014,2014,,,,45431,45435,1005,38131,3,38135,3
1005,41785,3,42366,3,581,2014,2015,,,,45435,46016,1005,38135,3,38716,3
1006,40805,4,41047,5,242,2011,2012,,,,44455,44697,1006,37155,4,37397,5
1006,41047,5,41270,5,223,2012,2012,,,,44697,44920,1006,37397,5,37620,5
1006,41270,5,42366,7,1096,2012,2015,,,,44920,46016,1006,37620,5,38716,7
1006,41270,7,41778,6,508,2012,2014,,,,44920,45428,1006,37620,7,38128,6
1006,41778,6,41786,6,8,2014,2014,,,,45428,45436,1006,38128,6,38136,6
1006,41786,6,41787,5,1,2014,2014,,,,45436,45437,1006,38136,6,38137,5
1006,41787,5,42147,4,360,2014,2015,,,,45437,45797,1006,38137,5,38497,4
1006,42147,4,42366,4,219,2015,2015,,,,45797,46016,1006,38497,4,38716,4
1007,40682,2,41421,3,739,2011,2013,,,,44332,45071,1007,37032,2,37771,3
1009,40844,3,42366,3,1522,2011,2015,,,,44494,46016,1009,37194,3,38716,3
1011,40174,6,40540,6,366,2009,2010,,,,43824,44190,1011,36524,6,36890,6
1011,40540,6,42366,6,1826,2010,2015,,,,44190,46016,1011,36890,6,38716,6
1012,39951,5,40174,5,223,2009,2009,,,,43601,43824,1012,36301,5,36524,5
1014,40052,3,42001,3,1949,2009,2014,,,,43702,45651,1014,36402,3,38351,3
1014,42001,3,42366,3,365,2014,2015,,,,45651,46016,1014,38351,3,38716,3
1015,42001,6,42183,5,182,2014,2015,,,,45651,45833,1015,38351,6,38533,5
1015,42183,5,42366,5,183,2015,2015,,,,45833,46016,1015,38533,5,38716,5
1016,39951,5,40540,4,589,2009,2010,,,,43601,44190,1016,36301,5,36890,4
1016,40540,4,42366,4,1826,2010,2015,,,,44190,46016,1016,36890,4,38716,4
1018,40540,7,40722,7,182,2010,2011,,,,44190,44372,1018,36890,7,37072,7
1018,40722,7,41870,7,1148,2011,2014,,,,44372,45520,1018,37072,7,38220,7
1018,41870,7,42366,7,496,2014,2015,,,,45520,46016,1018,38220,7,38716,7
1019,40682,4,42366,4,1684,2011,2015,,,,44332,46016,1019,37032,4,38716,4
1020,40021,3,40540,2,519,2009,2010,,,,43671,44190,1020,36371,3,36890,2
1021,40174,2,41412,2,1238,2009,2013,,,,43824,45062,1021,36524,2,37762,2
1021,41412,2,41839,3,427,2013,2014,,,,45062,45489,1021,37762,2,38189,3
1021,41839,3,42001,3,162,2014,2014,,,,45489,45651,1021,38189,3,38351,3
1021,42001,3,42366,3,365,2014,2015,,,,45651,46016,1021,38351,3,38716,3
1022,40540,3,41270,4,730,2010,2012,,,,44190,44920,1022,36890,3,37620,4
1022,41270,4,42366,4,1096,2012,2015,,,,44920,46016,1022,37620,4,38716,4
1023,39951,5,41596,6,1645,2009,2013,,,,43601,45246,1023,36301,5,37946,6
1023,41596,6,42366,6,770,2013,2015,,,,45246,46016,1023,37946,6,38716,6
1024,42305,4,42366,4,61,2015,2015,,,,45955,46016,1024,38655,4,38716,4
1025,40682,4,41605,4,923,2011,2013,,,,44332,45255,1025,37032,4,37955,4
1025,41605,4,42366,4,761,2013,2015,,,,45255,46016,1025,37955,4,38716,4
1026,41056,4,42366,4,1310,2012,2015,,,,44706,46016,1026,37406,4,38716,4
1027,39960,4,40540,4,580,2009,2010,,,,43610,44190,1027,36310,4,36890,4
1027,40540,4,41179,4,639,2010,2012,,,,44190,44829,1027,36890,4,37529,4
1027,42001,4,42366,4,365,2014,2015,,,,45651,46016,1027,38351,4,38716,4
1028,40774,2,41605,3,831,2011,2013,,,,44424,45255,1028,37124,2,37955,3
1028,41605,3,42366,3,761,2013,2015,,,,45255,46016,1028,37955,3,38716,3
1029,40418,4,41635,4,1217,2010,2013,,,,44068,45285,1029,36768,4,37985,4
1029,41635,4,42366,4,731,2013,2015,,,,45285,46016,1029,37985,4,38716,4
1030,40083,4,40479,3,396,2009,2010,,,,43733,44129,1030,36433,4,36829,3
1030,40479,3,41871,3,1392,2010,2014,,,,44129,45521,1030,36829,3,38221,3
1030,41871,3,42366,3,495,2014,2015,,,,45521,46016,1030,38221,3,38716,3
1031,41504,6,42366,6,862,2013,2015,,,,45154,46016,1031,37854,6,38716,6
1032,39951,4,40510,3,559,2009,2010,,,,43601,44160,1032,36301,4,36860,3
1032,40510,3,41962,3,1452,2010,2014,,,,44160,45612,1032,36860,3,38312,3
1032,41962,3,42366,3,404,2014,2015,,,,45612,46016,1032,38312,3,38716,3
1033,40905,3,41787,2,882,2011,2014,,,,44555,45437,1033,37255,3,38137,2
1033,41787,2,42366,2,579,2014,2015,,,,45437,46016,1033,38137,2,38716,2
1034,40174,6,40691,7,517,2009,2011,,,,43824,44341,1034,36524,6,37041,7
1034,40691,7,40752,6,61,2011,2011,,,,44341,44402,1034,37041,7,37102,6
1034,40752,6,41056,8,304,2011,2012,,,,44402,44706,1034,37102,6,37406,8
1034,41056,8,41108,7,52,2012,2012,,,,44706,44758,1034,37406,8,37458,7
1034,41108,7,41940,7,832,2012,2014,,,,44758,45590,1034,37458,7,38290,7
1034,41940,7,42305,5,365,2014,2015,,,,45590,45955,1034,38290,7,38655,5
1034,42305,5,42366,5,61,2015,2015,,,,45955,46016,1034,38655,5,38716,5
1035,40540,4,42366,4,1826,2010,2015,,,,44190,46016,1035,36890,4,38716,4
1036,40326,6,41148,7,822,2010,2012,,,,43976,44798,1036,36676,6,37498,7
1038,40174,7,40348,7,174,2009,2010,,,,43824,43998,1038,36524,7,36698,7
1038,40348,7,41179,7,831,2010,2012,,,,43998,44829,1038,36698,7,37529,7
1038,41179,7,42366,7,1187,2012,2015,,,,44829,46016,1038,37529,7,38716,7
1040,40540,2,42366,2,1826,2010,2015,,,,44190,46016,1040,36890,2,38716,2
1045,40317,4,42366,4,2049,2010,2015,,,,43967,46016,1045,36667,4,38716,4
1046,39951,5,41412,4,1461,2009,2013,,,,43601,45062,1046,36301,5,37762,4
1046,41412,4,42001,4,589,2013,2014,,,,45062,45651,1046,37762,4,38351,4
1046,42001,4,42366,4,365,2014,2015,,,,45651,46016,1046,38351,4,38716,4
1048,40348,5,42366,5,2018,2010,2015,,,,43998,46016,1048,36698,5,38716,5
1049,39951,6,40174,6,223,2009,2009,,,,43601,43824,1049,36301,6,36524,6
1049,40174,6,40905,7,731,2009,2011,,,,43824,44555,1049,36524,6,37255,7
1050,41270,5,42366,5,1096,2012,2015,,,,44920,46016,1050,37620,5,38716,5
1051,41047,4,41270,5,223,2012,2012,,,,44697,44920,1051,37397,4,37620,5
1051,41270,5,41962,4,692,2012,2014,,,,44920,45612,1051,37620,5,38312,4
1051,41962,4,42366,4,404,2014,2015,,,,45612,46016,1051,38312,4,38716,4
1052,40682,5,40905,5,223,2011,2011,,,,44332,44555,1052,37032,5,37255,5
1052,40905,5,41412,5,507,2011,2013,,,,44555,45062,1052,37255,5,37762,5
1052,41412,5,41787,6,375,2013,2014,,,,45062,45437,1052,37762,5,38137,6
1052,41787,6,41818,7,31,2014,2014,,,,45437,45468,1052,38137,6,38168,7
1053,40682,4,40745,4,63,2011,2011,,,,44332,44395,1053,37032,4,37095,4
1053,40745,4,42366,4,1621,2011,2015,,,,44395,46016,1053,37095,4,38716,4
1054,40682,2,40814,3,132,2011,2011,,,,44332,44464,1054,37032,2,37164,3
1054,40814,3,42366,3,1552,2011,2015,,,,44464,46016,1054,37164,3,38716,3
1055,41635,3,42366,3,731,2013,2015,,,,45285,46016,1055,37985,3,38716,3
1056,41544,4,42366,4,822,2013,2015,,,,45194,46016,1056,37894,4,38716,4
1057,40510,4,41078,4,568,2010,2012,,,,44160,44728,1057,36860,4,37428,4
1057,41078,4,42366,4,1288,2012,2015,,,,44728,46016,1057,37428,4,38716,4
1058,40317,3,42366,3,2049,2010,2015,,,,43967,46016,1058,36667,3,38716,3
1059,40317,2,42366,2,2049,2010,2015,,,,43967,46016,1059,36667,2,38716,2
1060,39951,5,40174,5,223,2009,2009,,,,43601,43824,1060,36301,5,36524,5
1060,40174,5,42366,5,2192,2009,2015,,,,43824,46016,1060,36524,5,38716,5
1060,40174,5,41778,5,1604,2009,2014,,,,43824,45428,1060,36524,5,38128,5
1060,41778,5,42366,5,588,2014,2015,,,,45428,46016,1060,38128,5,38716,5
1061,41047,2,42366,2,1319,2012,2015,,,,44697,46016,1061,37397,2,38716,2
1062,41270,5,41504,5,234,2012,2013,,,,44920,45154,1062,37620,5,37854,5
1062,41504,5,42366,5,862,2013,2015,,,,45154,46016,1062,37854,5,38716,5
1063,40905,2,41047,3,142,2011,2012,,,,44555,44697,1063,37255,2,37397,3
1063,41047,3,42366,3,1319,2012,2015,,,,44697,46016,1063,37397,3,38716,3
1064,40440,4,41270,5,830,2010,2012,,,,44090,44920,1064,36790,4,37620,5
1064,41270,5,41421,5,151,2012,2013,,,,44920,45071,1064,37620,5,37771,5
1064,41421,5,42366,5,945,2013,2015,,,,45071,46016,1064,37771,5,38716,5
1065,40844,2,40905,2,61,2011,2011,,,,44494,44555,1065,37194,2,37255,2
1065,40905,2,41053,3,148,2011,2012,,,,44555,44703,1065,37255,2,37403,3
1065,41053,3,42366,3,1313,2012,2015,,,,44703,46016,1065,37403,3,38716,3
1066,40174,3,41848,4,1674,2009,2014,,,,43824,45498,1066,36524,3,38198,4
1066,41848,4,42366,4,518,2014,2015,,,,45498,46016,1066,38198,4,38716,4
1068,39951,2,42366,2,2415,2009,2015,,,,43601,46016,1068,36301,2,38716,2
1069,41782,1,42366,1,584,2014,2015,,,,45432,46016,1069,38132,1,38716,1
1070,40685,2,40866,2,181,2011,2011,,,,44335,44516,1070,37035,2,37216,2
1070,40866,2,41047,3,181,2011,2012,,,,44516,44697,1070,37216,2,37397,3
1070,41047,3,42366,3,1319,2012,2015,,,,44697,46016,1070,37397,3,38716,3
1071,39951,6,40013,7,62,2009,2009,,,,43601,43663,1071,36301,6,36363,7
1071,40013,7,40174,7,161,2009,2009,,,,43663,43824,1071,36363,7,36524,7
1072,40479,3,41179,3,700,2010,2012,,,,44129,44829,1072,36829,3,37529,3
1072,41179,3,41270,3,91,2012,2012,,,,44829,44920,1072,37529,3,37620,3
1072,41270,3,42366,3,1096,2012,2015,,,,44920,46016,1072,37620,3,38716,3
1073,41200,3,42366,3,1166,2012,2015,,,,44850,46016,1073,37550,3,38716,3
1074,41200,3,42366,3,1166,2012,2015,,,,44850,46016,1074,37550,3,38716,3
1075,39951,5,39960,4,9,2009,2009,,,,43601,43610,1075,36301,5,36310,4
1075,39960,4,41047,4,1087,2009,2012,,,,43610,44697,1075,36310,4,37397,4
1075,41047,4,42143,4,1096,2012,2015,,,,44697,45793,1075,37397,4,38493,4
1075,42143,4,42366,4,223,2015,2015,,,,45793,46016,1075,38493,4,38716,4
1078,40104,6,40691,6,587,2009,2011,,,,43754,44341,1078,36454,6,37041,6
1078,40691,6,41270,6,579,2011,2012,,,,44341,44920,1078,37041,6,37620,6
1078,41270,6,41809,6,539,2012,2014,,,,44920,45459,1078,37620,6,38159,6
1080,39951,5,40449,4,498,2009,2010,,,,43601,44099,1080,36301,5,36799,4
1080,40449,4,41047,6,598,2010,2012,,,,44099,44697,1080,36799,4,37397,6
1080,41047,6,42366,7,1319,2012,2015,,,,44697,46016,1080,37397,6,38716,7
1080,41047,7,42366,8,1319,2012,2015,,,,44697,46016,1080,37397,7,38716,8
1080,41148,7,42366,7,1218,2012,2015,,,,44798,46016,1080,37498,7,38716,7
1081,40470,6,40905,6,435,2010,2011,,,,44120,44555,1081,36820,6,37255,6
1081,40905,6,41087,7,182,2011,2012,,,,44555,44737,1081,37255,6,37437,7
1081,41087,7,42366,7,1279,2012,2015,,,,44737,46016,1081,37437,7,38716,7
1084,39951,3,40540,2,589,2009,2010,,,,43601,44190,1084,36301,3,36890,2
1085,39960,2,42366,2,2406,2009,2015,,,,43610,46016,1085,36310,2,38716,2
1086,41635,3,42366,3,731,2013,2015,,,,45285,46016,1086,37985,3,38716,3
1087,41910,6,42366,6,456,2014,2015,,,,45560,46016,1087,38260,6,38716,6
1088,40510,5,41047,5,537,2010,2012,,,,44160,44697,1088,36860,5,37397,5
1088,41047,5,41635,5,588,2012,2013,,,,44697,45285,1088,37397,5,37985,5
1088,41635,5,41778,6,143,2013,2014,,,,45285,45428,1088,37985,5,38128,6
1088,41778,6,42366,6,588,2014,2015,,,,45428,46016,1088,38128,6,38716,6
1089,40387,5,42305,5,1918,2010,2015,,,,44037,45955,1089,36737,5,38655,5
1089,42305,5,42366,5,61,2015,2015,,,,45955,46016,1089,38655,5,38716,5
1090,40510,5,42143,5,1633,2010,2015,,,,44160,45793,1090,36860,5,38493,5
1090,42143,5,42366,5,223,2015,2015,,,,45793,46016,1090,38493,5,38716,5
1092,42001,4,42366,4,365,2014,2015,,,,45651,46016,1092,38351,4,38716,4
1093,40540,4,41270,4,730,2010,2012,,,,44190,44920,1093,36890,4,37620,4
1093,41270,4,42143,4,873,2012,2015,,,,44920,45793,1093,37620,4,38493,4
1093,42143,4,42366,4,223,2015,2015,,,,45793,46016,1093,38493,4,38716,4
1094,41240,4,42366,4,1126,2012,2015,,,,44890,46016,1094,37590,4,38716,4
1095,40814,4,41870,4,1056,2011,2014,,,,44464,45520,1095,37164,4,38220,4
1095,41870,4,42366,4,496,2014,2015,,,,45520,46016,1095,38220,4,38716,4
1096,41049,5,42366,5,1317,2012,2015,,,,44699,46016,1096,37399,5,38716,5
1097,41047,3,41574,4,527,2012,2013,,,,44697,45224,1097,37397,3,37924,4
1097,41574,4,41787,3,213,2013,2014,,,,45224,45437,1097,37924,4,38137,3
1097,41787,3,42366,3,579,2014,2015,,,,45437,46016,1097,38137,3,38716,3
1098,39960,3,40318,3,358,2009,2010,,,,43610,43968,1098,36310,3,36668,3
1098,40318,3,42366,3,2048,2010,2015,,,,43968,46016,1098,36668,3,38716,3
1099,40317,3,42366,3,2049,2010,2015,,,,43967,46016,1099,36667,3,38716,3
1100,41412,2,42366,2,954,2013,2015,,,,45062,46016,1100,37762,2,38716,2
1101,39951,4,40905,4,954,2009,2011,,,,43601,44555,1101,36301,4,37255,4
1101,40905,4,41513,4,608,2011,2013,,,,44555,45163,1101,37255,4,37863,4
1101,41513,4,42143,5,630,2013,2015,,,,45163,45793,1101,37863,4,38493,5
1101,42143,5,42366,5,223,2015,2015,,,,45793,46016,1101,38493,5,38716,5
1102,41635,6,42366,6,731,2013,2015,,,,45285,46016,1102,37985,6,38716,6
1103,40442,7,40844,8,402,2010,2011,,,,44092,44494,1103,36792,7,37194,8
1103,40844,8,42366,8,1522,2011,2015,,,,44494,46016,1103,37194,8,38716,8
1104,40905,2,42366,2,1461,2011,2015,,,,44555,46016,1104,37255,2,38716,2
1105,40317,3,42366,3,2049,2010,2015,,,,43967,46016,1105,36667,3,38716,3
1106,40083,5,41179,6,1096,2009,2012,,,,43733,44829,1106,36433,5,37529,6
1106,41179,6,42366,6,1187,2012,2015,,,,44829,46016,1106,37529,6,38716,6
1108,40074,4,40113,4,39,2009,2009,,,,43724,43763,1108,36424,4,36463,4
1108,40113,4,41052,3,939,2009,2012,,,,43763,44702,1108,36463,4,37402,3
1108,41052,3,42366,3,1314,2012,2015,,,,44702,46016,1108,37402,3,38716,3
1109,40021,4,40174,4,153,2009,2009,,,,43671,43824,1109,36371,4,36524,4
1109,40174,4,41117,3,943,2009,2012,,,,43824,44767,1109,36524,4,37467,3
1109,41117,3,42366,3,1249,2012,2015,,,,44767,46016,1109,37467,3,38716,3
1111,41787,4,42366,4,579,2014,2015,,,,45437,46016,1111,38137,4,38716,4
1113,40174,7,40743,7,569,2009,2011,,,,43824,44393,1113,36524,7,37093,7
1113,40743,7,42366,7,1623,2011,2015,,,,44393,46016,1113,37093,7,38716,7
1114,40074,6,40540,6,466,2009,2010,,,,43724,44190,1114,36424,6,36890,6
1114,40540,6,42366,8,1826,2010,2015,,,,44190,46016,1114,36890,6,38716,8
1115,40174,5,40540,6,366,2009,2010,,,,43824,44190,1115,36524,5,36890,6
1115,40540,6,40691,5,151,2010,2011,,,,44190,44341,1115,36890,6,37041,5
1115,40691,5,42366,5,1675,2011,2015,,,,44341,46016,1115,37041,5,38716,5
1116,41778,4,42366,4,588,2014,2015,,,,45428,46016,1116,38128,4,38716,4
1118,39960,4,41052,5,1092,2009,2012,,,,43610,44702,1118,36310,4,37402,5
1118,41052,5,41108,4,56,2012,2012,,,,44702,44758,1118,37402,5,37458,4
1118,41108,4,41778,4,670,2012,2014,,,,44758,45428,1118,37458,4,38128,4
1118,41778,4,42143,3,365,2014,2015,,,,45428,45793,1118,38128,4,38493,3
1118,42143,3,42366,3,223,2015,2015,,,,45793,46016,1118,38493,3,38716,3
1119,40682,3,41421,4,739,2011,2013,,,,44332,45071,1119,37032,3,37771,4
1119,41421,4,41778,3,357,2013,2014,,,,45071,45428,1119,37771,4,38128,3
1119,41778,3,42366,3,588,2014,2015,,,,45428,46016,1119,38128,3,38716,3
1120,39960,4,42366,4,2406,2009,2015,,,,43610,46016,1120,36310,4,38716,4
1121,39960,4,40174,4,214,2009,2009,,,,43610,43824,1121,36310,4,36524,4
1121,40174,4,42366,4,2192,2009,2015,,,,43824,46016,1121,36524,4,38716,4
1121,40174,4,40774,4,600,2009,2011,,,,43824,44424,1121,36524,4,37124,4
1121,40774,4,42366,4,1592,2011,2015,,,,44424,46016,1121,37124,4,38716,4
1122,41056,3,41544,3,488,2012,2013,,,,44706,45194,1122,37406,3,37894,3
1122,41544,3,41635,4,91,2013,2013,,,,45194,45285,1122,37894,3,37985,4
1122,41635,4,42366,4,731,2013,2015,,,,45285,46016,1122,37985,4,38716,4
1123,40321,4,41078,4,757,2010,2012,,,,43971,44728,1123,36671,4,37428,4
1123,41078,4,42366,4,1288,2012,2015,,,,44728,46016,1123,37428,4,38716,4
1124,42001,4,42366,4,365,2014,2015,,,,45651,46016,1124,38351,4,38716,4
1125,41270,3,42366,4,1096,2012,2015,,,,44920,46016,1125,37620,3,38716,4
1125,41270,4,42366,4,1096,2012,2015,,,,44920,46016,1125,37620,4,38716,4
1126,40835,5,41170,6,335,2011,2012,,,,44485,44820,1126,37185,5,37520,6
1126,41170,6,41513,6,343,2012,2013,,,,44820,45163,1126,37520,6,37863,6
1126,41513,6,42366,6,853,2013,2015,,,,45163,46016,1126,37863,6,38716,6
1127,41108,2,42366,2,1258,2012,2015,,,,44758,46016,1127,37458,2,38716,2
1128,42001,2,42366,2,365,2014,2015,,,,45651,46016,1128,38351,2,38716,2
1130,41778,5,42366,5,588,2014,2015,,,,45428,46016,1130,38128,5,38716,5
1131,41200,3,42366,3,1166,2012,2015,,,,44850,46016,1131,37550,3,38716,3
1132,40326,3,40682,3,356,2010,2011,,,,43976,44332,1132,36676,3,37032,3
1132,40682,3,41078,4,396,2011,2012,,,,44332,44728,1132,37032,3,37428,4
1132,41078,4,41087,5,9,2012,2012,,,,44728,44737,1132,37428,4,37437,5
1132,41087,5,41574,5,487,2012,2013,,,,44737,45224,1132,37437,5,37924,5
1132,41574,5,42366,5,792,2013,2015,,,,45224,46016,1132,37924,5,38716,5
1133,41412,4,42366,4,954,2013,2015,,,,45062,46016,1133,37762,4,38716,4
1134,40540,4,41117,3,577,2010,2012,,,,44190,44767,1134,36890,4,37467,3
1134,41117,3,42366,3,1249,2012,2015,,,,44767,46016,1134,37467,3,38716,3
1135,39982,5,40326,5,344,2009,2010,,,,43632,43976,1135,36332,5,36676,5
1135,40326,5,40713,6,387,2010,2011,,,,43976,44363,1135,36676,5,37063,6
1135,40713,6,41270,7,557,2011,2012,,,,44363,44920,1135,37063,6,37620,7
1135,41270,7,41513,6,243,2012,2013,,,,44920,45163,1135,37620,7,37863,6
1135,41513,6,41605,8,92,2013,2013,,,,45163,45255,1135,37863,6,37955,8
1135,41605,8,42143,7,538,2013,2015,,,,45255,45793,1135,37955,8,38493,7
1135,42143,7,42366,7,223,2015,2015,,,,45793,46016,1135,38493,7,38716,7
1136,40774,3,41117,4,343,2011,2012,,,,44424,44767,1136,37124,3,37467,4
1136,41117,4,42366,4,1249,2012,2015,,,,44767,46016,1136,37467,4,38716,4
1137,40104,3,42366,3,2262,2009,2015,,,,43754,46016,1137,36454,3,38716,3
1138,40449,2,42366,2,1917,2010,2015,,,,44099,46016,1138,36799,2,38716,2
1139,40174,7,40905,7,731,2009,2011,,,,43824,44555,1139,36524,7,37255,7
1139,40905,7,41270,7,365,2011,2012,,,,44555,44920,1139,37255,7,37620,7
1139,41270,7,41635,8,365,2012,2013,,,,44920,45285,1139,37620,7,37985,8
1140,40722,2,41179,3,457,2011,2012,,,,44372,44829,1140,37072,2,37529,3
1140,41179,3,42366,3,1187,2012,2015,,,,44829,46016,1140,37529,3,38716,3
1141,40540,4,42366,4,1826,2010,2015,,,,44190,46016,1141,36890,4,38716,4
1142,40682,2,42366,2,1684,2011,2015,,,,44332,46016,1142,37032,2,38716,2
1143,40844,4,42001,4,1157,2011,2014,,,,44494,45651,1143,37194,4,38351,4
1143,42001,4,42366,4,365,2014,2015,,,,45651,46016,1143,38351,4,38716,4
1145,39960,2,41047,3,1087,2009,2012,,,,43610,44697,1145,36310,2,37397,3
1145,41047,3,41635,3,588,2012,2013,,,,44697,45285,1145,37397,3,37985,3
1145,41635,3,42366,3,731,2013,2015,,,,45285,46016,1145,37985,3,38716,3
1147,40387,3,40905,3,518,2010,2011,,,,44037,44555,1147,36737,3,37255,3
1147,40905,3,41270,4,365,2011,2012,,,,44555,44920,1147,37255,3,37620,4
1147,41270,4,42366,4,1096,2012,2015,,,,44920,46016,1147,37620,4,38716,4
1148,39991,4,41506,4,1515,2009,2013,,,,43641,45156,1148,36341,4,37856,4
1148,41506,4,42366,4,860,2013,2015,,,,45156,46016,1148,37856,4,38716,4
1149,39960,4,41626,4,1666,2009,2013,,,,43610,45276,1149,36310,4,37976,4
1149,41626,4,42366,4,740,2013,2015,,,,45276,46016,1149,37976,4,38716,4
1150,39951,4,40174,4,223,2009,2009,,,,43601,43824,1150,36301,4,36524,4
1150,40174,4,42366,4,2192,2009,2015,,,,43824,46016,1150,36524,4,38716,4
1150,40174,4,40905,4,731,2009,2011,,,,43824,44555,1150,36524,4,37255,4
1150,40905,4,42366,4,1461,2011,2015,,,,44555,46016,1150,37255,4,38716,4
1151,41778,4,42366,4,588,2014,2015,,,,45428,46016,1151,38128,4,38716,4
1152,40317,2,41635,3,1318,2010,2013,,,,43967,45285,1152,36667,2,37985,3
1152,41635,3,42366,3,731,2013,2015,,,,45285,46016,1152,37985,3,38716,3
1153,40320,4,40689,4,369,2010,2011,,,,43970,44339,1153,36670,4,37039,4
1153,40689,4,40905,5,216,2011,2011,,,,44339,44555,1153,37039,4,37255,5
1153,40905,5,41870,4,965,2011,2014,,,,44555,45520,1153,37255,5,38220,4
1153,41870,4,42366,4,496,2014,2015,,,,45520,46016,1153,38220,4,38716,4
1154,39954,3,40174,3,220,2009,2009,,,,43604,43824,1154,36304,3,36524,3
1154,40174,3,41056,3,882,2009,2012,,,,43824,44706,1154,36524,3,37406,3
1154,41056,3,41901,3,845,2012,2014,,,,44706,45551,1154,37406,3,38251,3
1154,41901,3,42366,3,465,2014,2015,,,,45551,46016,1154,38251,3,38716,3
1155,40682,3,42366,3,1684,2011,2015,,,,44332,46016,1155,37032,3,38716,3
1156,41270,2,42366,2,1096,2012,2015,,,,44920,46016,1156,37620,2,38716,2
1157,40326,3,42366,3,2040,2010,2015,,,,43976,46016,1157,36676,3,38716,3
1159,41148,6,42366,6,1218,2012,2015,,,,44798,46016,1159,37498,6,38716,6
1160,40540,3,41635,3,1095,2010,2013,,,,44190,45285,1160,36890,3,37985,3
1160,41635,3,42366,3,731,2013,2015,,,,45285,46016,1160,37985,3,38716,3
1161,41778,4,42366,4,588,2014,2015,,,,45428,46016,1161,38128,4,38716,4
1162,40174,1,42366,1,2192,2009,2015,,,,43824,46016,1162,36524,1,38716,1
1163,39951,3,41047,6,1096,2009,2012,,,,43601,44697,1163,36301,3,37397,6
1163,41047,6,42366,8,1319,2012,2015,,,,44697,46016,1163,37397,6,38716,8
1163,41047,8,41056,5,9,2012,2012,,,,44697,44706,1163,37397,8,37406,5
1163,41056,5,41209,4,153,2012,2012,,,,44706,44859,1163,37406,5,37559,4
1164,41047,4,41056,6,9,2012,2012,,,,44697,44706,1164,37397,4,37406,6
1164,41056,6,41170,7,114,2012,2012,,,,44706,44820,1164,37406,6,37520,7
1164,41170,7,41412,6,242,2012,2013,,,,44820,45062,1164,37520,7,37762,6
1164,41412,6,41962,6,550,2013,2014,,,,45062,45612,1164,37762,6,38312,6
1164,41962,6,42366,6,404,2014,2015,,,,45612,46016,1164,38312,6,38716,6
1165,40540,5,40905,5,365,2010,2011,,,,44190,44555,1165,36890,5,37255,5
1165,40905,5,41421,4,516,2011,2013,,,,44555,45071,1165,37255,5,37771,4
1165,41421,4,42366,4,945,2013,2015,,,,45071,46016,1165,37771,4,38716,4
1166,40317,3,41270,3,953,2010,2012,,,,43967,44920,1166,36667,3,37620,3
1167,40012,6,41565,5,1553,2009,2013,,,,43662,45215,1167,36362,6,37915,5
1167,41565,5,42366,5,801,2013,2015,,,,45215,46016,1167,37915,5,38716,5
1168,40113,6,41148,5,1035,2009,2012,,,,43763,44798,1168,36463,6,37498,5
1168,41148,5,42366,5,1218,2012,2015,,,,44798,46016,1168,37498,5,38716,5
1169,39951,5,39960,5,9,2009,2009,,,,43601,43610,1169,36301,5,36310,5
1169,39960,5,40540,6,580,2009,2010,,,,43610,44190,1169,36310,5,36890,6
1169,40540,6,40905,6,365,2010,2011,,,,44190,44555,1169,36890,6,37255,6
1169,41270,4,42366,4,1096,2012,2015,,,,44920,46016,1169,37620,4,38716,4
1170,41412,5,42366,5,954,2013,2015,,,,45062,46016,1170,37762,5,38716,5
1171,39982,6,41787,6,1805,2009,2014,,,,43632,45437,1171,36332,6,38137,6
1171,41787,6,42366,6,579,2014,2015,,,,45437,46016,1171,38137,6,38716,6
1173,39951,5,40012,6,61,2009,2009,,,,43601,43662,1173,36301,5,36362,6
1173,40012,6,40317,5,305,2009,2010,,,,43662,43967,1173,36362,6,36667,5
1176,40540,4,41173,4,633,2010,2012,,,,44190,44823,1176,36890,4,37523,4
1176,41173,4,42366,4,1193,2012,2015,,,,44823,46016,1176,37523,4,38716,4
1177,41421,2,42366,2,945,2013,2015,,,,45071,46016,1177,37771,2,38716,2
1178,40409,5,42001,4,1592,2010,2014,,,,44059,45651,1178,36759,5,38351,4
1178,42001,4,42366,4,365,2014,2015,,,,45651,46016,1178,38351,4,38716,4
1181,40905,5,41047,5,142,2011,2012,,,,44555,44697,1181,37255,5,37397,5
1181,41047,5,41787,5,740,2012,2014,,,,44697,45437,1181,37397,5,38137,5
1181,41787,5,42366,5,579,2014,2015,,,,45437,46016,1181,38137,5,38716,5
1182,40174,7,42366,7,2192,2009,2015,,,,43824,46016,1182,36524,7,38716,7
1183,41270,2,41778,2,508,2012,2014,,,,44920,45428,1183,37620,2,38128,2
1183,41778,2,42366,2,588,2014,2015,,,,45428,46016,1183,38128,2,38716,2
1185,40165,2,41787,2,1622,2009,2014,,,,43815,45437,1185,36515,2,38137,2
1185,41787,2,42366,2,579,2014,2015,,,,45437,46016,1185,38137,2,38716,2
1186,40174,3,41787,2,1613,2009,2014,,,,43824,45437,1186,36524,3,38137,2
1186,41787,2,42366,2,579,2014,2015,,,,45437,46016,1186,38137,2,38716,2
1187,40540,6,41635,6,1095,2010,2013,,,,44190,45285,1187,36890,6,37985,6
1187,41635,6,42366,6,731,2013,2015,,,,45285,46016,1187,37985,6,38716,6
1188,40052,2,40357,2,305,2009,2010,,,,43702,44007,1188,36402,2,36707,2
1188,40357,2,40682,3,325,2010,2011,,,,44007,44332,1188,36707,2,37032,3
1188,40682,3,42366,3,1684,2011,2015,,,,44332,46016,1188,37032,3,38716,3
1188,40682,3,42001,4,1319,2011,2014,,,,44332,45651,1188,37032,3,38351,4
1188,42001,4,42366,4,365,2014,2015,,,,45651,46016,1188,38351,4,38716,4
1189,39951,2,40326,2,375,2009,2010,,,,43601,43976,1189,36301,2,36676,2
1189,40326,2,40540,3,214,2010,2010,,,,43976,44190,1189,36676,2,36890,3
1189,40540,3,40691,3,151,2010,2011,,,,44190,44341,1189,36890,3,37041,3
1190,41971,4,42366,4,395,2014,2015,,,,45621,46016,1190,38321,4,38716,4
1192,39951,3,42366,3,2415,2009,2015,,,,43601,46016,1192,36301,3,38716,3
1193,41421,6,42366,6,945,2013,2015,,,,45071,46016,1193,37771,6,38716,6
1194,40012,4,40113,4,101,2009,2009,,,,43662,43763,1194,36362,4,36463,4
1194,40113,4,40174,4,61,2009,2009,,,,43763,43824,1194,36463,4,36524,4
1194,40174,4,40903,4,729,2009,2011,,,,43824,44553,1194,36524,4,37253,4
1194,40903,4,42366,4,1463,2011,2015,,,,44553,46016,1194,37253,4,38716,4
1195,39951,5,40776,6,825,2009,2011,,,,43601,44426,1195,36301,5,37126,6
1195,40776,6,41778,5,1002,2011,2014,,,,44426,45428,1195,37126,6,38128,5
1195,41778,5,42366,5,588,2014,2015,,,,45428,46016,1195,38128,5,38716,5
1196,40691,4,42366,4,1675,2011,2015,,,,44341,46016,1196,37041,4,38716,4
1197,40174,5,40317,6,143,2009,2010,,,,43824,43967,1197,36524,5,36667,6
1197,40317,6,41209,6,892,2010,2012,,,,43967,44859,1197,36667,6,37559,6
1197,41209,6,41412,7,203,2012,2013,,,,44859,45062,1197,37559,6,37762,7
1197,41412,7,41473,6,61,2013,2013,,,,45062,45123,1197,37762,7,37823,6
1197,41473,6,42366,6,893,2013,2015,,,,45123,46016,1197,37823,6,38716,6
1198,41421,4,42366,4,945,2013,2015,,,,45071,46016,1198,37771,4,38716,4
1199,40479,4,42366,4,1887,2010,2015,,,,44129,46016,1199,36829,4,38716,4
1200,40905,2,42366,2,1461,2011,2015,,,,44555,46016,1200,37255,2,38716,2
1203,41421,2,42366,2,945,2013,2015,,,,45071,46016,1203,37771,2,38716,2
1204,40905,2,42366,2,1461,2011,2015,,,,44555,46016,1204,37255,2,38716,2
1205,41056,3,41635,4,579,2012,2013,,,,44706,45285,1205,37406,3,37985,4
1205,41635,4,41783,4,148,2013,2014,,,,45285,45433,1205,37985,4,38133,4
1205,41783,4,42366,4,583,2014,2015,,,,45433,46016,1205,38133,4,38716,4
1206,40174,4,41240,4,1066,2009,2012,,,,43824,44890,1206,36524,4,37590,4
1206,41240,4,41635,4,395,2012,2013,,,,44890,45285,1206,37590,4,37985,4
1206,41635,4,42366,5,731,2013,2015,,,,45285,46016,1206,37985,4,38716,5
1206,41635,5,42366,5,731,2013,2015,,,,45285,46016,1206,37985,5,38716,5
1207,40317,4,40326,4,9,2010,2010,,,,43967,43976,1207,36667,4,36676,4
1207,40326,4,42366,4,2040,2010,2015,,,,43976,46016,1207,36676,4,38716,4
1208,40691,4,41574,4,883,2011,2013,,,,44341,45224,1208,37041,4,37924,4
1208,41574,4,42143,5,569,2013,2015,,,,45224,45793,1208,37924,4,38493,5
1208,42143,5,42275,4,132,2015,2015,,,,45793,45925,1208,38493,5,38625,4
1208,42275,4,42366,4,91,2015,2015,,,,45925,46016,1208,38625,4,38716,4
1210,40043,6,40684,5,641,2009,2011,,,,43693,44334,1210,36393,6,37034,5
1210,40684,5,42366,5,1682,2011,2015,,,,44334,46016,1210,37034,5,38716,5
1211,40174,5,40540,5,366,2009,2010,,,,43824,44190,1211,36524,5,36890,5
1211,40540,5,40774,6,234,2010,2011,,,,44190,44424,1211,36890,5,37124,6
1211,40774,6,41452,6,678,2011,2013,,,,44424,45102,1211,37124,6,37802,6
1211,41452,6,42366,6,914,2013,2015,,,,45102,46016,1211,37802,6,38716,6
1212,40905,2,41605,3,700,2011,2013,,,,44555,45255,1212,37255,2,37955,3
1212,41605,3,42366,3,761,2013,2015,,,,45255,46016,1212,37955,3,38716,3
1213,40691,3,42366,3,1675,2011,2015,,,,44341,46016,1213,37041,3,38716,3
1214,40325,3,40905,3,580,2010,2011,,,,43975,44555,1214,36675,3,37255,3
1214,40905,3,42366,3,1461,2011,2015,,,,44555,46016,1214,37255,3,38716,3
1215,42001,5,42152,6,151,2014,2015,,,,45651,45802,1215,38351,5,38502,6
1215,42152,6,42366,6,214,2015,2015,,,,45802,46016,1215,38502,6,38716,6
1216,41179,4,42366,4,1187,2012,2015,,,,44829,46016,1216,37529,4,38716,4
1217,40317,8,40387,8,70,2010,2010,,,,43967,44037,1217,36667,8,36737,8
1220,40317,3,42366,3,2049,2010,2015,,,,43967,46016,1220,36667,3,38716,3
1221,40326,2,42366,2,2040,2010,2015,,,,43976,46016,1221,36676,2,38716,2
1222,40317,3,42366,3,2049,2010,2015,,,,43967,46016,1222,36667,3,38716,3
1223,40752,3,41910,3,1158,2011,2014,,,,44402,45560,1223,37102,3,38260,3
1223,41910,3,42366,3,456,2014,2015,,,,45560,46016,1223,38260,3,38716,3
1224,41047,2,42152,2,1105,2012,2015,,,,44697,45802,1224,37397,2,38502,2
1224,42152,2,42366,2,214,2015,2015,,,,45802,46016,1224,38502,2,38716,2
1225,41635,3,42366,3,731,2013,2015,,,,45285,46016,1225,37985,3,38716,3
1226,40378,4,40691,4,313,2010,2011,,,,44028,44341,1226,36728,4,37041,4
1226,40691,4,41047,4,356,2011,2012,,,,44341,44697,1226,37041,4,37397,4
1226,41047,4,41139,5,92,2012,2012,,,,44697,44789,1226,37397,4,37489,5
1226,41139,5,41544,6,405,2012,2013,,,,44789,45194,1226,37489,5,37894,6
1226,41544,6,42143,6,599,2013,2015,,,,45194,45793,1226,37894,6,38493,6
1226,42143,6,42366,6,223,2015,2015,,,,45793,46016,1226,38493,6,38716,6
1227,40326,4,40905,5,579,2010,2011,,,,43976,44555,1227,36676,4,37255,5
1228,40866,4,41270,4,404,2011,2012,,,,44516,44920,1228,37216,4,37620,4
1229,39960,5,40540,5,580,2009,2010,,,,43610,44190,1229,36310,5,36890,5
1229,40540,5,41085,4,545,2010,2012,,,,44190,44735,1229,36890,5,37435,4
1229,41085,4,41565,4,480,2012,2013,,,,44735,45215,1229,37435,4,37915,4
1229,41565,4,42366,4,801,2013,2015,,,,45215,46016,1229,37915,4,38716,4
1230,42001,2,42152,2,151,2014,2015,,,,45651,45802,1230,38351,2,38502,2
1230,42152,2,42366,2,214,2015,2015,,,,45802,46016,1230,38502,2,38716,2
1232,41056,4,42366,4,1310,2012,2015,,,,44706,46016,1232,37406,4,38716,4
1233,40905,3,41415,4,510,2011,2013,,,,44555,45065,1233,37255,3,37765,4
1234,40074,3,41787,4,1713,2009,2014,,,,43724,45437,1234,36424,3,38137,4
1234,41787,4,42366,4,579,2014,2015,,,,45437,46016,1234,38137,4,38716,4
1235,40174,2,41412,2,1238,2009,2013,,,,43824,45062,1235,36524,2,37762,2
1235,41412,2,41870,3,458,2013,2014,,,,45062,45520,1235,37762,2,38220,3
1235,41870,3,42001,3,131,2014,2014,,,,45520,45651,1235,38220,3,38351,3
1235,42001,3,42366,3,365,2014,2015,,,,45651,46016,1235,38351,3,38716,3
1236,39982,5,40479,4,497,2009,2010,,,,43632,44129,1236,36332,5,36829,4
1236,40479,4,41240,4,761,2010,2012,,,,44129,44890,1236,36829,4,37590,4
1236,41240,4,42152,4,912,2012,2015,,,,44890,45802,1236,37590,4,38502,4
1236,42152,4,42366,4,214,2015,2015,,,,45802,46016,1236,38502,4,38716,4
1238,40540,5,41544,5,1004,2010,2013,,,,44190,45194,1238,36890,5,37894,5
1238,41544,5,42366,5,822,2013,2015,,,,45194,46016,1238,37894,5,38716,5
1239,39951,4,41056,4,1105,2009,2012,,,,43601,44706,1239,36301,4,37406,4
1239,41056,4,41200,5,144,2012,2012,,,,44706,44850,1239,37406,4,37550,5
1239,41200,5,41421,6,221,2012,2013,,,,44850,45071,1239,37550,5,37771,6
1239,41421,6,42366,6,945,2013,2015,,,,45071,46016,1239,37771,6,38716,6
1240,40113,4,40479,4,366,2009,2010,,,,43763,44129,1240,36463,4,36829,4
1240,40479,4,40540,5,61,2010,2010,,,,44129,44190,1240,36829,4,36890,5
1240,40540,5,41047,6,507,2010,2012,,,,44190,44697,1240,36890,5,37397,6
1240,41047,6,41078,6,31,2012,2012,,,,44697,44728,1240,37397,6,37428,6
1240,41078,6,41962,6,884,2012,2014,,,,44728,45612,1240,37428,6,38312,6
1240,41962,6,42366,6,404,2014,2015,,,,45612,46016,1240,38312,6,38716,6
1241,40012,2,41048,3,1036,2009,2012,,,,43662,44698,1241,36362,2,37398,3
1241,41048,3,42366,3,1318,2012,2015,,,,44698,46016,1241,37398,3,38716,3
1244,40774,5,42366,5,1592,2011,2015,,,,44424,46016,1244,37124,5,38716,5
1245,40717,4,42366,4,1649,2011,2015,,,,44367,46016,1245,37067,4,38716,4
1246,40866,6,41047,6,181,2011,2012,,,,44516,44697,1246,37216,6,37397,6
1246,41047,6,41421,6,374,2012,2013,,,,44697,45071,1246,37397,6,37771,6
1246,41421,6,41635,5,214,2013,2013,,,,45071,45285,1246,37771,6,37985,5
1246,41635,5,41787,4,152,2013,2014,,,,45285,45437,1246,37985,5,38137,4
1248,40174,4,41056,3,882,2009,2012,,,,43824,44706,1248,36524,4,37406,3
1249,40682,4,40752,6,70,2011,2011,,,,44332,44402,1249,37032,4,37102,6
1249,40752,6,41635,5,883,2011,2013,,,,44402,45285,1249,37102,6,37985,5
1249,41635,5,42366,5,731,2013,2015,,,,45285,46016,1249,37985,5,38716,5
1251,40682,7,40896,8,214,2011,2011,,,,44332,44546,1251,37032,7,37246,8
1251,40896,8,40905,7,9,2011,2011,,,,44546,44555,1251,37246,8,37255,7
1251,40905,7,41047,8,142,2011,2012,,,,44555,44697,1251,37255,7,37397,8
1252,40174,5,40691,6,517,2009,2011,,,,43824,44341,1252,36524,5,37041,6
1252,40691,6,41056,7,365,2011,2012,,,,44341,44706,1252,37041,6,37406,7
1252,41544,8,42366,8,822,2013,2015,,,,45194,46016,1252,37894,8,38716,8
1256,40844,4,41473,4,629,2011,2013,,,,44494,45123,1256,37194,4,37823,4
1256,41473,4,42366,4,893,2013,2015,,,,45123,46016,1256,37823,4,38716,4
1257,40174,4,42366,4,2192,2009,2015,,,,43824,46016,1257,36524,4,38716,4
1258,41809,3,42366,3,557,2014,2015,,,,45459,46016,1258,38159,3,38716,3
1259,41047,5,42275,4,1228,2012,2015,,,,44697,45925,1259,37397,5,38625,4
1259,42275,4,42366,4,91,2015,2015,,,,45925,46016,1259,38625,4,38716,4
1260,40322,4,41787,4,1465,2010,2014,,,,43972,45437,1260,36672,4,38137,4
1260,41787,4,42366,4,579,2014,2015,,,,45437,46016,1260,38137,4,38716,4
1261,40052,4,40348,3,296,2009,2010,,,,43702,43998,1261,36402,4,36698,3
1261,40348,3,41809,3,1461,2010,2014,,,,43998,45459,1261,36698,3,38159,3
1261,41809,3,41901,3,92,2014,2014,,,,45459,45551,1261,38159,3,38251,3
1261,41901,3,42366,3,465,2014,2015,,,,45551,46016,1261,38251,3,38716,3
1262,41270,3,42366,3,1096,2012,2015,,,,44920,46016,1262,37620,3,38716,3
1263,41056,5,41412,6,356,2012,2013,,,,44706,45062,1263,37406,5,37762,6
1263,41412,6,41421,7,9,2013,2013,,,,45062,45071,1263,37762,6,37771,7
1263,41421,7,41870,6,449,2013,2014,,,,45071,45520,1263,37771,7,38220,6
1263,41870,6,42366,6,496,2014,2015,,,,45520,46016,1263,38220,6,38716,6
1264,39951,3,42366,3,2415,2009,2015,,,,43601,46016,1264,36301,3,38716,3
1266,40540,3,41270,4,730,2010,2012,,,,44190,44920,1266,36890,3,37620,4
1266,41270,4,42366,4,1096,2012,2015,,,,44920,46016,1266,37620,4,38716,4
1267,41056,3,42366,3,1310,2012,2015,,,,44706,46016,1267,37406,3,38716,3
1268,40174,7,41543,6,1369,2009,2013,,,,43824,45193,1268,36524,7,37893,6
1268,41543,6,42366,6,823,2013,2015,,,,45193,46016,1268,37893,6,38716,6
1269,42149,3,42366,3,217,2015,2015,,,,45799,46016,1269,38499,3,38716,3
1270,42366,3,42366,3,0,2015,2015,,,,46016,46016,1270,38716,3,38716,3
1271,40317,3,42001,3,1684,2010,2014,,,,43967,45651,1271,36667,3,38351,3
1271,42001,3,42366,3,365,2014,2015,,,,45651,46016,1271,38351,3,38716,3
1272,40317,3,42366,3,2049,2010,2015,,,,43967,46016,1272,36667,3,38716,3
1273,41818,4,42366,4,548,2014,2015,,,,45468,46016,1273,38168,4,38716,4
1274,40357,4,41839,4,1482,2010,2014,,,,44007,45489,1274,36707,4,38189,4
1274,41839,4,42366,4,527,2014,2015,,,,45489,46016,1274,38189,4,38716,4
1275,40174,5,42366,5,2192,2009,2015,,,,43824,46016,1275,36524,5,38716,5
1276,41056,5,41139,4,83,2012,2012,,,,44706,44789,1276,37406,5,37489,4
1276,41139,4,41635,5,496,2012,2013,,,,44789,45285,1276,37489,4,37985,5
1276,41635,5,42366,5,731,2013,2015,,,,45285,46016,1276,37985,5,38716,5
1277,40449,3,41635,1,1186,2010,2013,,,,44099,45285,1277,36799,3,37985,1
1277,41635,1,42366,1,731,2013,2015,,,,45285,46016,1277,37985,1,38716,1
1279,41200,5,41421,7,221,2012,2013,,,,44850,45071,1279,37550,5,37771,7
1279,41635,8,42366,8,731,2013,2015,,,,45285,46016,1279,37985,8,38716,8
1280,40326,3,42366,3,2040,2010,2015,,,,43976,46016,1280,36676,3,38716,3
1281,42213,3,42366,3,153,2015,2015,,,,45863,46016,1281,38563,3,38716,3
1283,40043,5,42366,5,2323,2009,2015,,,,43693,46016,1283,36393,5,38716,5
1284,39951,3,40083,3,132,2009,2009,,,,43601,43733,1284,36301,3,36433,3
1285,40326,3,40387,2,61,2010,2010,,,,43976,44037,1285,36676,3,36737,2
1285,40387,2,40691,4,304,2010,2011,,,,44037,44341,1285,36737,2,37041,4
1285,40691,4,40875,4,184,2011,2011,,,,44341,44525,1285,37041,4,37225,4
1285,40875,4,41416,4,541,2011,2013,,,,44525,45066,1285,37225,4,37766,4
1285,41416,4,41635,4,219,2013,2013,,,,45066,45285,1285,37766,4,37985,4
1285,41635,4,42366,4,731,2013,2015,,,,45285,46016,1285,37985,4,38716,4
1286,40326,2,41200,2,874,2010,2012,,,,43976,44850,1286,36676,2,37550,2
1286,41200,2,41787,2,587,2012,2014,,,,44850,45437,1286,37550,2,38137,2
1286,41787,2,42366,2,579,2014,2015,,,,45437,46016,1286,38137,2,38716,2
1287,40540,5,40682,8,142,2010,2011,,,,44190,44332,1287,36890,5,37032,8
1287,40682,8,40691,7,9,2011,2011,,,,44332,44341,1287,37032,8,37041,7
1288,41931,4,42366,4,435,2014,2015,,,,45581,46016,1288,38281,4,38716,4
1289,40113,1,42366,1,2253,2009,2015,,,,43763,46016,1289,36463,1,38716,1
1290,40113,3,40174,3,61,2009,2009,,,,43763,43824,1290,36463,3,36524,3
1290,40174,3,40743,3,569,2009,2011,,,,43824,44393,1290,36524,3,37093,3
1290,40743,3,42366,3,1623,2011,2015,,,,44393,46016,1290,37093,3,38716,3
1291,40440,2,41270,3,830,2010,2012,,,,44090,44920,1291,36790,2,37620,3
1291,41270,3,42001,2,731,2012,2014,,,,44920,45651,1291,37620,3,38351,2
1291,42001,2,42366,2,365,2014,2015,,,,45651,46016,1291,38351,2,38716,2
1292,41200,3,42366,3,1166,2012,2015,,,,44850,46016,1292,37550,3,38716,3
1293,40540,3,40875,3,335,2010,2011,,,,44190,44525,1293,36890,3,37225,3
1293,40875,3,41139,3,264,2011,2012,,,,44525,44789,1293,37225,3,37489,3
1293,41139,3,42366,3,1227,2012,2015,,,,44789,46016,1293,37489,3,38716,3
1294,39951,3,40783,3,832,2009,2011,,,,43601,44433,1294,36301,3,37133,3
1294,40783,3,40905,3,122,2011,2011,,,,44433,44555,1294,37133,3,37255,3
1294,40905,3,41047,4,142,2011,2012,,,,44555,44697,1294,37255,3,37397,4
1294,41047,4,41635,4,588,2012,2013,,,,44697,45285,1294,37397,4,37985,4
1294,41635,4,42366,4,731,2013,2015,,,,45285,46016,1294,37985,4,38716,4
1295,41270,3,42366,3,1096,2012,2015,,,,44920,46016,1295,37620,3,38716,3
1296,41056,3,42366,3,1310,2012,2015,,,,44706,46016,1296,37406,3,38716,3
1297,41047,3,41270,4,223,2012,2012,,,,44697,44920,1297,37397,3,37620,4
1297,41270,4,42366,4,1096,2012,2015,,,,44920,46016,1297,37620,4,38716,4
1298,40317,2,41270,1,953,2010,2012,,,,43967,44920,1298,36667,2,37620,1
1298,41270,1,42366,1,1096,2012,2015,,,,44920,46016,1298,37620,1,38716,1
1299,41270,2,42366,2,1096,2012,2015,,,,44920,46016,1299,37620,2,38716,2
1300,40104,5,40722,5,618,2009,2011,,,,43754,44372,1300,36454,5,37072,5
1301,40141,3,41778,3,1637,2009,2014,,,,43791,45428,1301,36491,3,38128,3
1301,41778,3,42366,3,588,2014,2015,,,,45428,46016,1301,38128,3,38716,3
1302,40470,3,41418,3,948,2010,2013,,,,44120,45068,1302,36820,3,37768,3
1302,41418,3,42366,3,948,2013,2015,,,,45068,46016,1302,37768,3,38716,3
1303,40682,3,41787,3,1105,2011,2014,,,,44332,45437,1303,37032,3,38137,3
1303,41787,3,42366,3,579,2014,2015,,,,45437,46016,1303,38137,3,38716,3
1305,41635,6,42366,6,731,2013,2015,,,,45285,46016,1305,37985,6,38716,6
1306,40052,5,40174,6,122,2009,2009,,,,43702,43824,1306,36402,5,36524,6
1306,40174,6,41412,6,1238,2009,2013,,,,43824,45062,1306,36524,6,37762,6
1306,41412,6,42366,6,954,2013,2015,,,,45062,46016,1306,37762,6,38716,6
1309,40317,3,41787,3,1470,2010,2014,,,,43967,45437,1309,36667,3,38137,3
1309,41787,3,42366,3,579,2014,2015,,,,45437,46016,1309,38137,3,38716,3
1310,41419,3,42001,2,582,2013,2014,,,,45069,45651,1310,37769,3,38351,2
1310,42001,2,42366,2,365,2014,2015,,,,45651,46016,1310,38351,2,38716,2
1311,40814,5,41270,6,456,2011,2012,,,,44464,44920,1311,37164,5,37620,6
1311,41270,6,42149,6,879,2012,2015,,,,44920,45799,1311,37620,6,38499,6
1311,42149,6,42366,6,217,2015,2015,,,,45799,46016,1311,38499,6,38716,6
1312,41117,3,42366,3,1249,2012,2015,,,,44767,46016,1312,37467,3,38716,3
1314,41047,3,42366,4,1319,2012,2015,,,,44697,46016,1314,37397,3,38716,4
1314,42366,4,42366,4,0,2015,2015,,,,46016,46016,1314,38716,4,38716,4
1315,39951,2,40682,2,731,2009,2011,,,,43601,44332,1315,36301,2,37032,2
1315,40682,2,41139,2,457,2011,2012,,,,44332,44789,1315,37032,2,37489,2
1316,41443,6,41635,5,192,2013,2013,,,,45093,45285,1316,37793,6,37985,5
1316,41635,5,41787,6,152,2013,2014,,,,45285,45437,1316,37985,5,38137,6
1316,41787,6,42366,6,579,2014,2015,,,,45437,46016,1316,38137,6,38716,6
1317,40326,3,42366,3,2040,2010,2015,,,,43976,46016,1317,36676,3,38716,3
1318,41047,3,42366,3,1319,2012,2015,,,,44697,46016,1318,37397,3,38716,3
1320,40691,7,41148,8,457,2011,2012,,,,44341,44798,1320,37041,7,37498,8
1321,40805,2,42366,2,1561,2011,2015,,,,44455,46016,1321,37155,2,38716,2
1322,41421,2,42366,2,945,2013,2015,,,,45071,46016,1322,37771,2,38716,2
1323,40052,3,41962,3,1910,2009,2014,,,,43702,45612,1323,36402,3,38312,3
1323,41962,3,42366,3,404,2014,2015,,,,45612,46016,1323,38312,3,38716,3
1324,40743,2,42366,2,1623,2011,2015,,,,44393,46016,1324,37093,2,38716,2
1326,40113,3,40691,3,578,2009,2011,,,,43763,44341,1326,36463,3,37041,3
1326,40691,3,41056,4,365,2011,2012,,,,44341,44706,1326,37041,3,37406,4
1326,41056,4,41635,4,579,2012,2013,,,,44706,45285,1326,37406,4,37985,4
1326,41635,4,42366,4,731,2013,2015,,,,45285,46016,1326,37985,4,38716,4
1327,39951,4,41047,4,1096,2009,2012,,,,43601,44697,1327,36301,4,37397,4
1327,41047,4,42001,4,954,2012,2014,,,,44697,45651,1327,37397,4,38351,4
1327,42001,4,42366,4,365,2014,2015,,,,45651,46016,1327,38351,4,38716,4
1329,40174,6,40418,7,244,2009,2010,,,,43824,44068,1329,36524,6,36768,7
1330,40174,4,41047,6,873,2009,2012,,,,43824,44697,1330,36524,4,37397,6
1330,41047,6,41148,5,101,2012,2012,,,,44697,44798,1330,37397,6,37498,5
1330,41148,5,42366,5,1218,2012,2015,,,,44798,46016,1330,37498,5,38716,5
1331,41940,2,42366,2,426,2014,2015,,,,45590,46016,1331,38290,2,38716,2
1333,40174,5,40326,5,152,2009,2010,,,,43824,43976,1333,36524,5,36676,5
1333,40326,5,42366,5,2040,2010,2015,,,,43976,46016,1333,36676,5,38716,5
1335,41270,2,42001,3,731,2012,2014,,,,44920,45651,1335,37620,2,38351,3
1335,42001,3,42366,3,365,2014,2015,,,,45651,46016,1335,38351,3,38716,3
1336,41142,2,42366,2,1224,2012,2015,,,,44792,46016,1336,37492,2,38716,2
1337,41635,3,42366,3,731,2013,2015,,,,45285,46016,1337,37985,3,38716,3
1339,40317,4,42366,4,2049,2010,2015,,,,43967,46016,1339,36667,4,38716,4
1341,41270,4,42275,4,1005,2012,2015,,,,44920,45925,1341,37620,4,38625,4
1341,42275,4,42366,4,91,2015,2015,,,,45925,46016,1341,38625,4,38716,4
1342,40326,3,41056,3,730,2010,2012,,,,43976,44706,1342,36676,3,37406,3
1342,41056,3,41787,4,731,2012,2014,,,,44706,45437,1342,37406,3,38137,4
1342,41787,4,42366,4,579,2014,2015,,,,45437,46016,1342,38137,4,38716,4
1344,40174,6,41605,7,1431,2009,2013,,,,43824,45255,1344,36524,6,37955,7
1344,41605,7,42366,8,761,2013,2015,,,,45255,46016,1344,37955,7,38716,8
1344,42366,8,42366,8,0,2015,2015,,,,46016,46016,1344,38716,8,38716,8
1346,40174,4,41787,4,1613,2009,2014,,,,43824,45437,1346,36524,4,38137,4
1346,41787,4,42366,4,579,2014,2015,,,,45437,46016,1346,38137,4,38716,4
1347,39951,5,40043,6,92,2009,2009,,,,43601,43693,1347,36301,5,36393,6
1347,40043,6,41047,6,1004,2009,2012,,,,43693,44697,1347,36393,6,37397,6
1348,40501,2,41270,2,769,2010,2012,,,,44151,44920,1348,36851,2,37620,2
1348,41270,2,42366,2,1096,2012,2015,,,,44920,46016,1348,37620,2,38716,2
1349,39960,5,41209,6,1249,2009,2012,,,,43610,44859,1349,36310,5,37559,6
1349,41209,6,42143,5,934,2012,2015,,,,44859,45793,1349,37559,6,38493,5
1349,42143,5,42366,5,223,2015,2015,,,,45793,46016,1349,38493,5,38716,5
1350,40083,4,40691,4,608,2009,2011,,,,43733,44341,1350,36433,4,37041,4
1350,40691,4,41209,5,518,2011,2012,,,,44341,44859,1350,37041,4,37559,5
1350,41209,5,41787,4,578,2012,2014,,,,44859,45437,1350,37559,5,38137,4
1351,39951,5,40905,4,954,2009,2011,,,,43601,44555,1351,36301,5,37255,4
1351,40905,4,41971,4,1066,2011,2014,,,,44555,45621,1351,37255,4,38321,4
1351,41971,4,42366,4,395,2014,2015,,,,45621,46016,1351,38321,4,38716,4
1352,40144,5,40807,4,663,2009,2011,,,,43794,44457,1352,36494,5,37157,4
1352,40807,4,41778,4,971,2011,2014,,,,44457,45428,1352,37157,4,38128,4
1352,41778,4,42366,4,588,2014,2015,,,,45428,46016,1352,38128,4,38716,4
1353,41992,4,42366,4,374,2014,2015,,,,45642,46016,1353,38342,4,38716,4
1354,40470,4,41940,3,1470,2010,2014,,,,44120,45590,1354,36820,4,38290,3
1354,41940,3,42366,3,426,2014,2015,,,,45590,46016,1354,38290,3,38716,3
1355,41962,3,42366,3,404,2014,2015,,,,45612,46016,1355,38312,3,38716,3
1358,39951,4,40540,4,589,2009,2010,,,,43601,44190,1358,36301,4,36890,4
1359,40174,4,40317,4,143,2009,2010,,,,43824,43967,1359,36524,4,36667,4
1359,40317,4,40905,4,588,2010,2011,,,,43967,44555,1359,36667,4,37255,4
1359,41574,4,41778,4,204,2013,2014,,,,45224,45428,1359,37924,4,38128,4
1359,41778,4,42366,4,588,2014,2015,,,,45428,46016,1359,38128,4,38716,4
1360,39951,5,40691,4,740,2009,2011,,,,43601,44341,1360,36301,5,37041,4
1360,40691,4,41910,4,1219,2011,2014,,,,44341,45560,1360,37041,4,38260,4
1360,41910,4,42366,4,456,2014,2015,,,,45560,46016,1360,38260,4,38716,4
1361,40905,3,41270,4,365,2011,2012,,,,44555,44920,1361,37255,3,37620,4
1361,41270,4,41412,4,142,2012,2013,,,,44920,45062,1361,37620,4,37762,4
1361,41412,4,42366,5,954,2013,2015,,,,45062,46016,1361,37762,4,38716,5
1361,41412,5,41535,5,123,2013,2013,,,,45062,45185,1361,37762,5,37885,5
1361,41535,5,41544,4,9,2013,2013,,,,45185,45194,1361,37885,5,37894,4
1361,41544,4,41931,4,387,2013,2014,,,,45194,45581,1361,37894,4,38281,4
1361,41931,4,41940,6,9,2014,2014,,,,45581,45590,1361,38281,4,38290,6
1362,40113,4,41635,4,1522,2009,2013,,,,43763,45285,1362,36463,4,37985,4
1362,41635,4,42366,4,731,2013,2015,,,,45285,46016,1362,37985,4,38716,4
1363,40905,4,41047,4,142,2011,2012,,,,44555,44697,1363,37255,4,37397,4
1363,41047,4,42366,4,1319,2012,2015,,,,44697,46016,1363,37397,4,38716,4
1364,42244,2,42366,2,122,2015,2015,,,,45894,46016,1364,38594,2,38716,2
1365,41047,4,42366,4,1319,2012,2015,,,,44697,46016,1365,37397,4,38716,4
1366,41870,2,42366,2,496,2014,2015,,,,45520,46016,1366,38220,2,38716,2
1367,40814,4,42366,4,1552,2011,2015,,,,44464,46016,1367,37164,4,38716,4
1368,40682,4,42366,4,1684,2011,2015,,,,44332,46016,1368,37032,4,38716,4
1370,40021,4,40378,4,357,2009,2010,,,,43671,44028,1370,36371,4,36728,4
1370,40378,4,42366,4,1988,2010,2015,,,,44028,46016,1370,36728,4,38716,4
1374,39951,5,40479,5,528,2009,2010,,,,43601,44129,1374,36301,5,36829,5
1374,40479,5,40691,4,212,2010,2011,,,,44129,44341,1374,36829,5,37041,4
1374,40691,4,40866,4,175,2011,2011,,,,44341,44516,1374,37041,4,37216,4
1374,40866,4,42152,4,1286,2011,2015,,,,44516,45802,1374,37216,4,38502,4
1374,42152,4,42366,4,214,2015,2015,,,,45802,46016,1374,38502,4,38716,4
1375,41270,3,42366,3,1096,2012,2015,,,,44920,46016,1375,37620,3,38716,3
1376,41139,1,42366,1,1227,2012,2015,,,,44789,46016,1376,37489,1,38716,1
1377,41412,3,42366,3,954,2013,2015,,,,45062,46016,1377,37762,3,38716,3
1378,40905,3,42366,3,1461,2011,2015,,,,44555,46016,1378,37255,3,38716,3
1379,41049,4,42366,4,1317,2012,2015,,,,44699,46016,1379,37399,4,38716,4
1380,40319,3,40691,4,372,2010,2011,,,,43969,44341,1380,36669,3,37041,4
1380,40691,4,42366,6,1675,2011,2015,,,,44341,46016,1380,37041,4,38716,6
1380,40691,6,40777,4,86,2011,2011,,,,44341,44427,1380,37041,6,37127,4
1380,40777,4,40835,6,58,2011,2011,,,,44427,44485,1380,37127,4,37185,6
1380,40835,6,41270,4,435,2011,2012,,,,44485,44920,1380,37185,6,37620,4
1380,41270,4,42366,4,1096,2012,2015,,,,44920,46016,1380,37620,4,38716,4
1380,41270,4,42152,3,882,2012,2015,,,,44920,45802,1380,37620,4,38502,3
1380,42152,3,42366,3,214,2015,2015,,,,45802,46016,1380,38502,3,38716,3
1381,40326,4,40774,6,448,2010,2011,,,,43976,44424,1381,36676,4,37124,6
1381,40774,6,40806,8,32,2011,2011,,,,44424,44456,1381,37124,6,37156,8
1381,40806,8,40835,4,29,2011,2011,,,,44456,44485,1381,37156,8,37185,4
1381,40835,4,40905,4,70,2011,2011,,,,44485,44555,1381,37185,4,37255,4
1382,40866,4,41078,5,212,2011,2012,,,,44516,44728,1382,37216,4,37428,5
1382,41078,5,42366,5,1288,2012,2015,,,,44728,46016,1382,37428,5,38716,5
1383,41056,4,41270,3,214,2012,2012,,,,44706,44920,1383,37406,4,37620,3
1383,41270,3,41778,3,508,2012,2014,,,,44920,45428,1383,37620,3,38128,3
1383,41778,3,42366,3,588,2014,2015,,,,45428,46016,1383,38128,3,38716,3
1384,41270,3,42366,4,1096,2012,2015,,,,44920,46016,1384,37620,3,38716,4
1384,41270,4,41910,3,640,2012,2014,,,,44920,45560,1384,37620,4,38260,3
1384,41910,3,42366,3,456,2014,2015,,,,45560,46016,1384,38260,3,38716,3
1385,40687,3,40713,4,26,2011,2011,,,,44337,44363,1385,37037,3,37063,4
1385,40713,4,40905,4,192,2011,2011,,,,44363,44555,1385,37063,4,37255,4
1385,40905,4,41056,6,151,2011,2012,,,,44555,44706,1385,37255,4,37406,6
1385,41056,6,41200,7,144,2012,2012,,,,44706,44850,1385,37406,6,37550,7
1385,41200,7,41270,4,70,2012,2012,,,,44850,44920,1385,37550,7,37620,4
1385,41270,4,42366,5,1096,2012,2015,,,,44920,46016,1385,37620,4,38716,5
1385,41270,5,42366,5,1096,2012,2015,,,,44920,46016,1385,37620,5,38716,5
1386,42001,4,42366,4,365,2014,2015,,,,45651,46016,1386,38351,4,38716,4
1387,40713,5,41421,7,708,2011,2013,,,,44363,45071,1387,37063,5,37771,7
1387,41421,7,42366,7,945,2013,2015,,,,45071,46016,1387,37771,7,38716,7
1388,40317,2,41635,2,1318,2010,2013,,,,43967,45285,1388,36667,2,37985,2
1388,41635,2,42366,2,731,2013,2015,,,,45285,46016,1388,37985,2,38716,2
1389,40540,3,42366,3,1826,2010,2015,,,,44190,46016,1389,36890,3,38716,3
1390,41047,4,41270,6,223,2012,2012,,,,44697,44920,1390,37397,4,37620,6
1390,41270,6,41635,6,365,2012,2013,,,,44920,45285,1390,37620,6,37985,6
1390,41635,6,41848,5,213,2013,2014,,,,45285,45498,1390,37985,6,38198,5
1390,41848,5,42366,5,518,2014,2015,,,,45498,46016,1390,38198,5,38716,5
1391,41047,4,41056,5,9,2012,2012,,,,44697,44706,1391,37397,4,37406,5
1391,41056,5,41179,4,123,2012,2012,,,,44706,44829,1391,37406,5,37529,4
1391,41179,4,42366,4,1187,2012,2015,,,,44829,46016,1391,37529,4,38716,4
1392,39982,5,40021,7,39,2009,2009,,,,43632,43671,1392,36332,5,36371,7
1392,40021,7,40043,6,22,2009,2009,,,,43671,43693,1392,36371,7,36393,6
1393,40449,2,42366,2,1917,2010,2015,,,,44099,46016,1393,36799,2,38716,2
1395,40866,4,41270,5,404,2011,2012,,,,44516,44920,1395,37216,4,37620,5
1395,41270,5,41412,7,142,2012,2013,,,,44920,45062,1395,37620,5,37762,7
1395,41412,7,42366,8,954,2013,2015,,,,45062,46016,1395,37762,7,38716,8
1396,41778,2,42366,2,588,2014,2015,,,,45428,46016,1396,38128,2,38716,2
1397,41231,3,42366,3,1135,2012,2015,,,,44881,46016,1397,37581,3,38716,3
1399,40713,4,41473,4,760,2011,2013,,,,44363,45123,1399,37063,4,37823,4
1399,41473,4,42366,4,893,2013,2015,,,,45123,46016,1399,37823,4,38716,4
1400,41412,5,42366,5,954,2013,2015,,,,45062,46016,1400,37762,5,38716,5
1401,40174,6,40326,3,152,2009,2010,,,,43824,43976,1401,36524,6,36676,3
1401,40326,3,40691,3,365,2010,2011,,,,43976,44341,1401,36676,3,37041,3
1401,40691,3,40835,4,144,2011,2011,,,,44341,44485,1401,37041,3,37185,4
1401,40835,4,41047,4,212,2011,2012,,,,44485,44697,1401,37185,4,37397,4
1401,41047,4,41179,5,132,2012,2012,,,,44697,44829,1401,37397,4,37529,5
1401,41179,5,42366,5,1187,2012,2015,,,,44829,46016,1401,37529,5,38716,5
1402,40012,6,40018,5,6,2009,2009,,,,43662,43668,1402,36362,6,36368,5
1402,40018,5,40326,7,308,2009,2010,,,,43668,43976,1402,36368,5,36676,7
1402,40326,7,41270,8,944,2010,2012,,,,43976,44920,1402,36676,7,37620,8
1403,40905,5,41047,6,142,2011,2012,,,,44555,44697,1403,37255,5,37397,6
1403,41047,6,41056,7,9,2012,2012,,,,44697,44706,1403,37397,6,37406,7
1403,41056,7,42366,7,1310,2012,2015,,,,44706,46016,1403,37406,7,38716,7
1403,41056,7,41209,7,153,2012,2012,,,,44706,44859,1403,37406,7,37559,7
1403,41209,7,41240,6,31,2012,2012,,,,44859,44890,1403,37559,7,37590,6
1403,41240,6,41270,8,30,2012,2012,,,,44890,44920,1403,37590,6,37620,8
1403,41940,7,42336,6,396,2014,2015,,,,45590,45986,1403,38290,7,38686,6
1403,42336,6,42366,6,30,2015,2015,,,,45986,46016,1403,38686,6,38716,6
1404,39951,6,39960,6,9,2009,2009,,,,43601,43610,1404,36301,6,36310,6
1404,39960,6,41179,6,1219,2009,2012,,,,43610,44829,1404,36310,6,37529,6
1404,41179,6,41270,7,91,2012,2012,,,,44829,44920,1404,37529,6,37620,7
1404,41270,7,41605,7,335,2012,2013,,,,44920,45255,1404,37620,7,37955,7
1405,40014,2,41412,2,1398,2009,2013,,,,43664,45062,1405,36364,2,37762,2
1405,41412,2,42366,2,954,2013,2015,,,,45062,46016,1405,37762,2,38716,2
1406,40905,3,42366,3,1461,2011,2015,,,,44555,46016,1406,37255,3,38716,3
1407,40470,2,41421,2,951,2010,2013,,,,44120,45071,1407,36820,2,37771,2
1407,41421,2,42366,2,945,2013,2015,,,,45071,46016,1407,37771,2,38716,2
1408,41047,6,42366,6,1319,2012,2015,,,,44697,46016,1408,37397,6,38716,6
1409,40682,2,41209,2,527,2011,2012,,,,44332,44859,1409,37032,2,37559,2
1409,41209,2,42366,2,1157,2012,2015,,,,44859,46016,1409,37559,2,38716,2
1410,40814,2,42366,2,1552,2011,2015,,,,44464,46016,1410,37164,2,38716,2
1411,41209,6,42001,5,792,2012,2014,,,,44859,45651,1411,37559,6,38351,5
1411,42001,5,42366,5,365,2014,2015,,,,45651,46016,1411,38351,5,38716,5
1412,39960,4,40905,4,945,2009,2011,,,,43610,44555,1412,36310,4,37255,4
1412,40905,4,42366,4,1461,2011,2015,,,,44555,46016,1412,37255,4,38716,4
1413,40317,4,41778,4,1461,2010,2014,,,,43967,45428,1413,36667,4,38128,4
1413,41778,4,41787,5,9,2014,2014,,,,45428,45437,1413,38128,4,38137,5
1413,41787,5,42336,4,549,2014,2015,,,,45437,45986,1413,38137,5,38686,4
1413,42336,4,42366,4,30,2015,2015,,,,45986,46016,1413,38686,4,38716,4
1414,40174,4,42366,4,2192,2009,2015,,,,43824,46016,1414,36524,4,38716,4
1415,39951,5,41544,6,1593,2009,2013,,,,43601,45194,1415,36301,5,37894,6
1415,41544,6,42366,6,822,2013,2015,,,,45194,46016,1415,37894,6,38716,6
1416,41997,3,42366,3,369,2014,2015,,,,45647,46016,1416,38347,3,38716,3
1417,41481,6,42366,6,885,2013,2015,,,,45131,46016,1417,37831,6,38716,6
1418,41050,2,42366,2,1316,2012,2015,,,,44700,46016,1418,37400,2,38716,2
1419,40691,2,41209,4,518,2011,2012,,,,44341,44859,1419,37041,2,37559,4
1419,41209,4,41270,3,61,2012,2012,,,,44859,44920,1419,37559,4,37620,3
1419,41270,3,42366,4,1096,2012,2015,,,,44920,46016,1419,37620,3,38716,4
1419,41270,4,42366,5,1096,2012,2015,,,,44920,46016,1419,37620,4,38716,5
1419,41270,5,42366,6,1096,2012,2015,,,,44920,46016,1419,37620,5,38716,6
1419,41270,6,41784,5,514,2012,2014,,,,44920,45434,1419,37620,6,38134,5
1419,41784,5,42366,5,582,2014,2015,,,,45434,46016,1419,38134,5,38716,5
1420,40174,3,42366,3,2192,2009,2015,,,,43824,46016,1420,36524,3,38716,3
1424,40540,7,42366,8,1826,2010,2015,,,,44190,46016,1424,36890,7,38716,8
1425,40326,3,41047,4,721,2010,2012,,,,43976,44697,1425,36676,3,37397,4
1425,41047,4,42366,4,1319,2012,2015,,,,44697,46016,1425,37397,4,38716,4
1427,40470,6,40905,6,435,2010,2011,,,,44120,44555,1427,36820,6,37255,6
1427,40905,6,41818,7,913,2011,2014,,,,44555,45468,1427,37255,6,38168,7
1427,41818,7,42001,6,183,2014,2014,,,,45468,45651,1427,38168,7,38351,6
1427,42001,6,42366,6,365,2014,2015,,,,45651,46016,1427,38351,6,38716,6
1428,40540,5,42366,8,1826,2010,2015,,,,44190,46016,1428,36890,5,38716,8
1428,40540,8,42366,8,1826,2010,2015,,,,44190,46016,1428,36890,8,38716,8
1429,41421,5,42366,5,945,2013,2015,,,,45071,46016,1429,37771,5,38716,5
1430,41412,3,42366,3,954,2013,2015,,,,45062,46016,1430,37762,3,38716,3
1431,40686,4,40752,7,66,2011,2011,,,,44336,44402,1431,37036,4,37102,7
1431,40752,7,41627,5,875,2011,2013,,,,44402,45277,1431,37102,7,37977,5
1431,41627,5,41635,6,8,2013,2013,,,,45277,45285,1431,37977,5,37985,6
1431,41635,6,41778,4,143,2013,2014,,,,45285,45428,1431,37985,6,38128,4
1431,41778,4,42143,4,365,2014,2015,,,,45428,45793,1431,38128,4,38493,4
1431,42143,4,42366,4,223,2015,2015,,,,45793,46016,1431,38493,4,38716,4
1432,40691,4,41056,4,365,2011,2012,,,,44341,44706,1432,37041,4,37406,4
1432,41056,4,42366,5,1310,2012,2015,,,,44706,46016,1432,37406,4,38716,5
1432,41056,5,42366,6,1310,2012,2015,,,,44706,46016,1432,37406,5,38716,6
1432,41056,6,41170,4,114,2012,2012,,,,44706,44820,1432,37406,6,37520,4
1432,41170,4,41635,6,465,2012,2013,,,,44820,45285,1432,37520,4,37985,6
1432,41635,6,41785,5,150,2013,2014,,,,45285,45435,1432,37985,6,38135,5
1432,41785,5,41873,3,88,2014,2014,,,,45435,45523,1432,38135,5,38223,3
1432,41873,3,42366,3,493,2014,2015,,,,45523,46016,1432,38223,3,38716,3
1434,41056,4,41108,5,52,2012,2012,,,,44706,44758,1434,37406,4,37458,5
1434,41108,5,41179,4,71,2012,2012,,,,44758,44829,1434,37458,5,37529,4
1434,41179,4,41209,3,30,2012,2012,,,,44829,44859,1434,37529,4,37559,3
1434,41209,3,42366,3,1157,2012,2015,,,,44859,46016,1434,37559,3,38716,3
1435,40866,4,42366,4,1500,2011,2015,,,,44516,46016,1435,37216,4,38716,4
1437,40174,2,41482,3,1308,2009,2013,,,,43824,45132,1437,36524,2,37832,3
1437,41482,3,41901,3,419,2013,2014,,,,45132,45551,1437,37832,3,38251,3
1437,41901,3,42366,3,465,2014,2015,,,,45551,46016,1437,38251,3,38716,3
1438,40440,4,42366,4,1926,2010,2015,,,,44090,46016,1438,36790,4,38716,4
1439,39960,6,42366,6,2406,2009,2015,,,,43610,46016,1439,36310,6,38716,6
1439,39960,6,40317,5,357,2009,2010,,,,43610,43967,1439,36310,6,36667,5
1439,40317,5,40449,6,132,2010,2010,,,,43967,44099,1439,36667,5,36799,6
1439,40449,6,40683,5,234,2010,2011,,,,44099,44333,1439,36799,6,37033,5
1439,40683,5,42366,5,1683,2011,2015,,,,44333,46016,1439,37033,5,38716,5
1440,40378,7,40691,8,313,2010,2011,,,,44028,44341,1440,36728,7,37041,8
1441,40384,2,40905,2,521,2010,2011,,,,44034,44555,1441,36734,2,37255,2
1441,40905,2,42366,2,1461,2011,2015,,,,44555,46016,1441,37255,2,38716,2
1442,40905,3,41179,4,274,2011,2012,,,,44555,44829,1442,37255,3,37529,4
1442,41179,4,41778,4,599,2012,2014,,,,44829,45428,1442,37529,4,38128,4
1442,41778,4,42366,4,588,2014,2015,,,,45428,46016,1442,38128,4,38716,4
1443,41270,4,42366,4,1096,2012,2015,,,,44920,46016,1443,37620,4,38716,4
1444,39951,4,41047,5,1096,2009,2012,,,,43601,44697,1444,36301,4,37397,5
1444,41047,5,41419,4,372,2012,2013,,,,44697,45069,1444,37397,5,37769,4
1444,41419,4,42366,4,947,2013,2015,,,,45069,46016,1444,37769,4,38716,4
1445,39960,3,40510,2,550,2009,2010,,,,43610,44160,1445,36310,3,36860,2
1445,40510,2,42366,2,1856,2010,2015,,,,44160,46016,1445,36860,2,38716,2
1446,40326,7,40387,7,61,2010,2010,,,,43976,44037,1446,36676,7,36737,7
1448,40012,7,41818,6,1806,2009,2014,,,,43662,45468,1448,36362,7,38168,6
1448,41818,6,42366,6,548,2014,2015,,,,45468,46016,1448,38168,6,38716,6
1449,40326,4,41209,4,883,2010,2012,,,,43976,44859,1449,36676,4,37559,4
1451,40174,6,40682,6,508,2009,2011,,,,43824,44332,1451,36524,6,37032,6
1451,40682,6,41047,7,365,2011,2012,,,,44332,44697,1451,37032,6,37397,7
1452,40684,3,41778,3,1094,2011,2014,,,,44334,45428,1452,37034,3,38128,3
1452,41778,3,42366,3,588,2014,2015,,,,45428,46016,1452,38128,3,38716,3
1454,41421,8,41635,7,214,2013,2013,,,,45071,45285,1454,37771,8,37985,7
1456,40144,3,40905,4,761,2009,2011,,,,43794,44555,1456,36494,3,37255,4
1456,40905,4,42366,4,1461,2011,2015,,,,44555,46016,1456,37255,4,38716,4
1457,40174,3,40326,4,152,2009,2010,,,,43824,43976,1457,36524,3,36676,4
1457,40326,4,40470,4,144,2010,2010,,,,43976,44120,1457,36676,4,36820,4
1457,40470,4,40682,5,212,2010,2011,,,,44120,44332,1457,36820,4,37032,5
1457,40682,5,41050,5,368,2011,2012,,,,44332,44700,1457,37032,5,37400,5
1457,41050,5,41787,5,737,2012,2014,,,,44700,45437,1457,37400,5,38137,5
1457,41787,5,42143,5,356,2014,2015,,,,45437,45793,1457,38137,5,38493,5
1457,42143,5,42366,5,223,2015,2015,,,,45793,46016,1457,38493,5,38716,5
1458,40113,3,41778,4,1665,2009,2014,,,,43763,45428,1458,36463,3,38128,4
1458,41778,4,42366,4,588,2014,2015,,,,45428,46016,1458,38128,4,38716,4
1460,40174,4,41047,4,873,2009,2012,,,,43824,44697,1460,36524,4,37397,4
1461,41421,4,42366,4,945,2013,2015,,,,45071,46016,1461,37771,4,38716,4
1462,40409,4,42366,4,1957,2010,2015,,,,44059,46016,1462,36759,4,38716,4
1463,40348,3,42366,3,2018,2010,2015,,,,43998,46016,1463,36698,3,38716,3
1464,39960,5,40043,4,83,2009,2009,,,,43610,43693,1464,36310,5,36393,4
1464,40043,4,40348,4,305,2009,2010,,,,43693,43998,1464,36393,4,36698,4
1464,40348,4,40807,4,459,2010,2011,,,,43998,44457,1464,36698,4,37157,4
1464,40807,4,42366,4,1559,2011,2015,,,,44457,46016,1464,37157,4,38716,4
1465,40104,4,40875,4,771,2009,2011,,,,43754,44525,1465,36454,4,37225,4
1465,40875,4,42366,4,1491,2011,2015,,,,44525,46016,1465,37225,4,38716,4
1466,39960,4,42366,4,2406,2009,2015,,,,43610,46016,1466,36310,4,38716,4
1467,40317,3,41078,3,761,2010,2012,,,,43967,44728,1467,36667,3,37428,3
1467,41078,3,42366,3,1288,2012,2015,,,,44728,46016,1467,37428,3,38716,3
1468,39991,4,40510,5,519,2009,2010,,,,43641,44160,1468,36341,4,36860,5
1468,40510,5,40540,5,30,2010,2010,,,,44160,44190,1468,36860,5,36890,5
1468,40540,5,40722,6,182,2010,2011,,,,44190,44372,1468,36890,5,37072,6
1468,40722,6,41240,6,518,2011,2012,,,,44372,44890,1468,37072,6,37590,6
1468,41240,6,42366,6,1126,2012,2015,,,,44890,46016,1468,37590,6,38716,6
1469,40691,2,42366,2,1675,2011,2015,,,,44341,46016,1469,37041,2,38716,2
1471,41940,2,42366,2,426,2014,2015,,,,45590,46016,1471,38290,2,38716,2
1472,40174,5,40409,6,235,2009,2010,,,,43824,44059,1472,36524,5,36759,6
1472,40409,6,42366,6,1957,2010,2015,,,,44059,46016,1472,36759,6,38716,6
1473,41513,3,42366,3,853,2013,2015,,,,45163,46016,1473,37863,3,38716,3
1475,40479,2,41056,1,577,2010,2012,,,,44129,44706,1475,36829,2,37406,1
1476,40409,6,40905,5,496,2010,2011,,,,44059,44555,1476,36759,6,37255,5
1476,40905,5,41270,5,365,2011,2012,,,,44555,44920,1476,37255,5,37620,5
1476,41270,5,41809,5,539,2012,2014,,,,44920,45459,1476,37620,5,38159,5
1476,41809,5,42366,5,557,2014,2015,,,,45459,46016,1476,38159,5,38716,5
1477,39960,3,40719,4,759,2009,2011,,,,43610,44369,1477,36310,3,37069,4
1477,40719,4,40722,4,3,2011,2011,,,,44369,44372,1477,37069,4,37072,4
1477,40722,4,42305,4,1583,2011,2015,,,,44372,45955,1477,37072,4,38655,4
1477,42305,4,42366,4,61,2015,2015,,,,45955,46016,1477,38655,4,38716,4
1479,39960,4,42305,4,2345,2009,2015,,,,43610,45955,1479,36310,4,38655,4
1479,42305,4,42366,4,61,2015,2015,,,,45955,46016,1479,38655,4,38716,4
1480,40685,3,42366,3,1681,2011,2015,,,,44335,46016,1480,37035,3,38716,3
1482,41421,4,41605,4,184,2013,2013,,,,45071,45255,1482,37771,4,37955,4
1482,41605,4,42366,4,761,2013,2015,,,,45255,46016,1482,37955,4,38716,4
1484,41412,4,41421,4,9,2013,2013,,,,45062,45071,1484,37762,4,37771,4
1484,41421,4,42366,4,945,2013,2015,,,,45071,46016,1484,37771,4,38716,4
1485,41879,5,42143,6,264,2014,2015,,,,45529,45793,1485,38229,5,38493,6
1485,42143,6,42366,6,223,2015,2015,,,,45793,46016,1485,38493,6,38716,6
1486,40479,4,40905,3,426,2010,2011,,,,44129,44555,1486,36829,4,37255,3
1486,40905,3,42366,3,1461,2011,2015,,,,44555,46016,1486,37255,3,38716,3
1487,41605,6,42366,6,761,2013,2015,,,,45255,46016,1487,37955,6,38716,6
1488,41270,4,42366,4,1096,2012,2015,,,,44920,46016,1488,37620,4,38716,4
1489,40104,6,40691,7,587,2009,2011,,,,43754,44341,1489,36454,6,37041,7
1489,40691,7,41108,8,417,2011,2012,,,,44341,44758,1489,37041,7,37458,8
1489,41108,8,41209,8,101,2012,2012,,,,44758,44859,1489,37458,8,37559,8
1490,41635,3,42366,3,731,2013,2015,,,,45285,46016,1490,37985,3,38716,3
1491,39960,5,40083,5,123,2009,2009,,,,43610,43733,1491,36310,5,36433,5
1491,40083,5,41421,6,1338,2009,2013,,,,43733,45071,1491,36433,5,37771,6
1491,41421,6,42305,5,884,2013,2015,,,,45071,45955,1491,37771,6,38655,5
1491,42305,5,42366,5,61,2015,2015,,,,45955,46016,1491,38655,5,38716,5
1493,40682,4,42366,4,1684,2011,2015,,,,44332,46016,1493,37032,4,38716,4
1494,40449,2,42366,2,1917,2010,2015,,,,44099,46016,1494,36799,2,38716,2
1495,41635,5,42366,5,731,2013,2015,,,,45285,46016,1495,37985,5,38716,5
1497,41787,6,42366,6,579,2014,2015,,,,45437,46016,1497,38137,6,38716,6
1498,40691,5,42366,5,1675,2011,2015,,,,44341,46016,1498,37041,5,38716,5
1499,40174,4,41270,3,1096,2009,2012,,,,43824,44920,1499,36524,4,37620,3
1499,41270,3,42366,3,1096,2012,2015,,,,44920,46016,1499,37620,3,38716,3
1500,39951,5,40682,6,731,2009,2011,,,,43601,44332,1500,36301,5,37032,6
1500,40682,6,40905,7,223,2011,2011,,,,44332,44555,1500,37032,6,37255,7
1501,41421,5,42366,5,945,2013,2015,,,,45071,46016,1501,37771,5,38716,5
1502,40691,4,41048,4,357,2011,2012,,,,44341,44698,1502,37041,4,37398,4
1502,41048,4,42366,4,1318,2012,2015,,,,44698,46016,1502,37398,4,38716,4
1503,41879,7,42366,7,487,2014,2015,,,,45529,46016,1503,38229,7,38716,7
1504,40326,2,42366,2,2040,2010,2015,,,,43976,46016,1504,36676,2,38716,2
1505,41635,3,42366,3,731,2013,2015,,,,45285,46016,1505,37985,3,38716,3
1506,40844,4,42001,5,1157,2011,2014,,,,44494,45651,1506,37194,4,38351,5
1506,42001,5,42366,5,365,2014,2015,,,,45651,46016,1506,38351,5,38716,5
1507,41087,4,41231,5,144,2012,2012,,,,44737,44881,1507,37437,4,37581,5
1507,41231,5,42366,5,1135,2012,2015,,,,44881,46016,1507,37581,5,38716,5
1508,40326,3,41270,4,944,2010,2012,,,,43976,44920,1508,36676,3,37620,4
1508,41270,4,41535,4,265,2012,2013,,,,44920,45185,1508,37620,4,37885,4
1508,41535,4,42366,4,831,2013,2015,,,,45185,46016,1508,37885,4,38716,4
1509,41535,4,42366,4,831,2013,2015,,,,45185,46016,1509,37885,4,38716,4
1510,42143,6,42366,6,223,2015,2015,,,,45793,46016,1510,38493,6,38716,6
1511,40844,3,42366,3,1522,2011,2015,,,,44494,46016,1511,37194,3,38716,3
1514,40540,4,41270,5,730,2010,2012,,,,44190,44920,1514,36890,4,37620,5
1514,41270,5,42366,6,1096,2012,2015,,,,44920,46016,1514,37620,5,38716,6
1514,41270,6,41787,6,517,2012,2014,,,,44920,45437,1514,37620,6,38137,6
1514,41787,6,42366,6,579,2014,2015,,,,45437,46016,1514,38137,6,38716,6
1517,41626,2,42366,2,740,2013,2015,,,,45276,46016,1517,37976,2,38716,2
1518,40691,2,42366,2,1675,2011,2015,,,,44341,46016,1518,37041,2,38716,2
1519,41412,3,42366,3,954,2013,2015,,,,45062,46016,1519,37762,3,38716,3
1521,40905,4,41209,4,304,2011,2012,,,,44555,44859,1521,37255,4,37559,4
1521,41209,4,41421,5,212,2012,2013,,,,44859,45071,1521,37559,4,37771,5
1521,41421,5,41809,3,388,2013,2014,,,,45071,45459,1521,37771,5,38159,3
1521,41809,3,42366,3,557,2014,2015,,,,45459,46016,1521,38159,3,38716,3
1522,42152,2,42366,2,214,2015,2015,,,,45802,46016,1522,38502,2,38716,2
1523,41787,3,42366,3,579,2014,2015,,,,45437,46016,1523,38137,3,38716,3
1524,41787,3,42366,3,579,2014,2015,,,,45437,46016,1524,38137,3,38716,3
1525,41787,4,42366,4,579,2014,2015,,,,45437,46016,1525,38137,4,38716,4
1526,41078,4,41778,4,700,2012,2014,,,,44728,45428,1526,37428,4,38128,4
1526,41778,4,42366,4,588,2014,2015,,,,45428,46016,1526,38128,4,38716,4
1527,40691,7,41870,7,1179,2011,2014,,,,44341,45520,1527,37041,7,38220,7
1528,39951,4,40326,4,375,2009,2010,,,,43601,43976,1528,36301,4,36676,4
1528,40326,4,42366,4,2040,2010,2015,,,,43976,46016,1528,36676,4,38716,4
1529,40844,4,41209,5,365,2011,2012,,,,44494,44859,1529,37194,4,37559,5
1529,41209,5,42366,5,1157,2012,2015,,,,44859,46016,1529,37559,5,38716,5
1530,40317,5,40814,5,497,2010,2011,,,,43967,44464,1530,36667,5,37164,5
1530,40814,5,40905,4,91,2011,2011,,,,44464,44555,1530,37164,5,37255,4
1530,40905,4,42366,4,1461,2011,2015,,,,44555,46016,1530,37255,4,38716,4
1531,40046,4,41940,4,1894,2009,2014,,,,43696,45590,1531,36396,4,38290,4
1531,41940,4,42366,4,426,2014,2015,,,,45590,46016,1531,38290,4,38716,4
1532,41412,4,42366,4,954,2013,2015,,,,45062,46016,1532,37762,4,38716,4
1533,41270,4,42366,4,1096,2012,2015,,,,44920,46016,1533,37620,4,38716,4
1534,40052,4,40317,3,265,2009,2010,,,,43702,43967,1534,36402,4,36667,3
1534,40317,3,41787,3,1470,2010,2014,,,,43967,45437,1534,36667,3,38137,3
1534,41787,3,42366,3,579,2014,2015,,,,45437,46016,1534,38137,3,38716,3
1536,41056,3,42366,3,1310,2012,2015,,,,44706,46016,1536,37406,3,38716,3
1538,40540,3,40905,3,365,2010,2011,,,,44190,44555,1538,36890,3,37255,3
1538,40905,3,42366,3,1461,2011,2015,,,,44555,46016,1538,37255,3,38716,3
1539,41270,5,42366,5,1096,2012,2015,,,,44920,46016,1539,37620,5,38716,5
1540,40689,3,42366,3,1677,2011,2015,,,,44339,46016,1540,37039,3,38716,3
1541,41108,1,42366,1,1258,2012,2015,,,,44758,46016,1541,37458,1,38716,1
1542,40317,3,40905,1,588,2010,2011,,,,43967,44555,1542,36667,3,37255,1
1543,40174,4,40875,4,701,2009,2011,,,,43824,44525,1543,36524,4,37225,4
1543,40875,4,42366,4,1491,2011,2015,,,,44525,46016,1543,37225,4,38716,4
1544,40326,3,41778,3,1452,2010,2014,,,,43976,45428,1544,36676,3,38128,3
1544,41778,3,42366,3,588,2014,2015,,,,45428,46016,1544,38128,3,38716,3
1546,39953,6,40174,5,221,2009,2009,,,,43603,43824,1546,36303,6,36524,5
1548,40317,2,41047,3,730,2010,2012,,,,43967,44697,1548,36667,2,37397,3
1548,41047,3,42366,3,1319,2012,2015,,,,44697,46016,1548,37397,3,38716,3
1549,41635,5,42366,6,731,2013,2015,,,,45285,46016,1549,37985,5,38716,6
1549,41635,6,42366,6,731,2013,2015,,,,45285,46016,1549,37985,6,38716,6
1550,41635,3,41901,3,266,2013,2014,,,,45285,45551,1550,37985,3,38251,3
1550,41901,3,42366,3,465,2014,2015,,,,45551,46016,1550,38251,3,38716,3
1552,40317,5,40378,7,61,2010,2010,,,,43967,44028,1552,36667,5,36728,7
1552,40378,7,40540,8,162,2010,2010,,,,44028,44190,1552,36728,7,36890,8
1552,40540,8,42366,7,1826,2010,2015,,,,44190,46016,1552,36890,8,38716,7
1553,39960,4,41901,4,1941,2009,2014,,,,43610,45551,1553,36310,4,38251,4
1553,41901,4,42366,4,465,2014,2015,,,,45551,46016,1553,38251,4,38716,4
1555,42001,2,42366,2,365,2014,2015,,,,45651,46016,1555,38351,2,38716,2
1558,39960,6,40418,7,458,2009,2010,,,,43610,44068,1558,36310,6,36768,7
1558,40418,7,40722,7,304,2010,2011,,,,44068,44372,1558,36768,7,37072,7
1558,40722,7,40783,7,61,2011,2011,,,,44372,44433,1558,37072,7,37133,7
1558,40783,7,41051,8,268,2011,2012,,,,44433,44701,1558,37133,7,37401,8
1558,41051,8,41778,7,727,2012,2014,,,,44701,45428,1558,37401,8,38128,7
1558,41778,7,42001,7,223,2014,2014,,,,45428,45651,1558,38128,7,38351,7
1558,42001,7,42366,7,365,2014,2015,,,,45651,46016,1558,38351,7,38716,7
1559,40317,3,40687,3,370,2010,2011,,,,43967,44337,1559,36667,3,37037,3
1559,40687,3,41270,3,583,2011,2012,,,,44337,44920,1559,37037,3,37620,3
1561,40326,3,40835,3,509,2010,2011,,,,43976,44485,1561,36676,3,37185,3
1561,40835,3,40844,3,9,2011,2011,,,,44485,44494,1561,37185,3,37194,3
1562,40351,5,42001,5,1650,2010,2014,,,,44001,45651,1562,36701,5,38351,5
1562,42001,5,42244,5,243,2014,2015,,,,45651,45894,1562,38351,5,38594,5
1562,42244,5,42366,5,122,2015,2015,,,,45894,46016,1562,38594,5,38716,5
1563,40012,6,40074,4,62,2009,2009,,,,43662,43724,1563,36362,6,36424,4
1563,40074,4,40174,5,100,2009,2009,,,,43724,43824,1563,36424,4,36524,5
1563,40174,5,40326,6,152,2009,2010,,,,43824,43976,1563,36524,5,36676,6
1563,40326,6,42366,7,2040,2010,2015,,,,43976,46016,1563,36676,6,38716,7
1563,40326,7,40540,7,214,2010,2010,,,,43976,44190,1563,36676,7,36890,7
1563,40540,7,40713,7,173,2010,2011,,,,44190,44363,1563,36890,7,37063,7
1563,40713,7,41635,7,922,2011,2013,,,,44363,45285,1563,37063,7,37985,7
1563,41635,7,41781,7,146,2013,2014,,,,45285,45431,1563,37985,7,38131,7
1563,41781,7,42366,7,585,2014,2015,,,,45431,46016,1563,38131,7,38716,7
1565,40684,2,40691,2,7,2011,2011,,,,44334,44341,1565,37034,2,37041,2
1565,40691,2,42366,2,1675,2011,2015,,,,44341,46016,1565,37041,2,38716,2
1566,41240,4,42143,4,903,2012,2015,,,,44890,45793,1566,37590,4,38493,4
1566,42143,4,42366,4,223,2015,2015,,,,45793,46016,1566,38493,4,38716,4
1568,40174,5,40805,6,631,2009,2011,,,,43824,44455,1568,36524,5,37155,6
1568,40805,6,40866,8,61,2011,2011,,,,44455,44516,1568,37155,6,37216,8
1569,39956,3,42366,3,2410,2009,2015,,,,43606,46016,1569,36306,3,38716,3
1570,40905,3,41510,3,605,2011,2013,,,,44555,45160,1570,37255,3,37860,3
1570,41510,3,42366,3,856,2013,2015,,,,45160,46016,1570,37860,3,38716,3
1571,40083,3,42366,3,2283,2009,2015,,,,43733,46016,1571,36433,3,38716,3
1573,41117,4,42366,4,1249,2012,2015,,,,44767,46016,1573,37467,4,38716,4
1574,40905,3,41047,4,142,2011,2012,,,,44555,44697,1574,37255,3,37397,4
1574,41047,4,41635,4,588,2012,2013,,,,44697,45285,1574,37397,4,37985,4
1574,41635,4,42366,4,731,2013,2015,,,,45285,46016,1574,37985,4,38716,4
1575,40052,7,40691,6,639,2009,2011,,,,43702,44341,1575,36402,7,37041,6
1575,40691,6,41117,6,426,2011,2012,,,,44341,44767,1575,37041,6,37467,6
1575,41117,6,41513,5,396,2012,2013,,,,44767,45163,1575,37467,6,37863,5
1575,41513,5,42143,5,630,2013,2015,,,,45163,45793,1575,37863,5,38493,5
1575,42143,5,42366,5,223,2015,2015,,,,45793,46016,1575,38493,5,38716,5
1576,40682,4,41962,5,1280,2011,2014,,,,44332,45612,1576,37032,4,38312,5
1576,41962,5,42366,5,404,2014,2015,,,,45612,46016,1576,38312,5,38716,5
1578,40317,2,40905,2,588,2010,2011,,,,43967,44555,1578,36667,2,37255,2
1578,40905,2,42366,2,1461,2011,2015,,,,44555,46016,1578,37255,2,38716,2
1579,40319,2,42366,2,2047,2010,2015,,,,43969,46016,1579,36669,2,38716,2
1581,40691,3,40722,3,31,2011,2011,,,,44341,44372,1581,37041,3,37072,3
1581,40722,3,41170,4,448,2011,2012,,,,44372,44820,1581,37072,3,37520,4
1581,41170,4,42366,5,1196,2012,2015,,,,44820,46016,1581,37520,4,38716,5
1582,41962,4,42366,4,404,2014,2015,,,,45612,46016,1582,38312,4,38716,4
1583,40540,3,42366,3,1826,2010,2015,,,,44190,46016,1583,36890,3,38716,3
1585,40752,5,42366,5,1614,2011,2015,,,,44402,46016,1585,37102,5,38716,5
1586,40682,4,40689,7,7,2011,2011,,,,44332,44339,1586,37032,4,37039,7
1586,40689,7,41148,5,459,2011,2012,,,,44339,44798,1586,37039,7,37498,5
1586,41148,5,41473,4,325,2012,2013,,,,44798,45123,1586,37498,5,37823,4
1589,40052,2,40357,2,305,2009,2010,,,,43702,44007,1589,36402,2,36707,2
1589,40357,2,40470,3,113,2010,2010,,,,44007,44120,1589,36707,2,36820,3
1589,40470,3,40691,3,221,2010,2011,,,,44120,44341,1589,36820,3,37041,3
1589,40691,3,40722,3,31,2011,2011,,,,44341,44372,1589,37041,3,37072,3
1589,40722,3,41787,4,1065,2011,2014,,,,44372,45437,1589,37072,3,38137,4
1589,41787,4,42366,4,579,2014,2015,,,,45437,46016,1589,38137,4,38716,4
1590,40905,3,41635,3,730,2011,2013,,,,44555,45285,1590,37255,3,37985,3
1590,41635,3,42366,3,731,2013,2015,,,,45285,46016,1590,37985,3,38716,3
1591,40144,6,40174,6,30,2009,2009,,,,43794,43824,1591,36494,6,36524,6
1591,40174,6,40777,7,603,2009,2011,,,,43824,44427,1591,36524,6,37127,7
1591,40777,7,41635,6,858,2011,2013,,,,44427,45285,1591,37127,7,37985,6
1591,41635,6,42001,6,366,2013,2014,,,,45285,45651,1591,37985,6,38351,6
1591,42001,6,42366,6,365,2014,2015,,,,45651,46016,1591,38351,6,38716,6
1592,40174,4,40691,4,517,2009,2011,,,,43824,44341,1592,36524,4,37041,4
1592,40691,4,41056,4,365,2011,2012,,,,44341,44706,1592,37041,4,37406,4
1592,41056,4,41417,3,361,2012,2013,,,,44706,45067,1592,37406,4,37767,3
1593,40174,3,41108,3,934,2009,2012,,,,43824,44758,1593,36524,3,37458,3
1593,41108,3,42366,3,1258,2012,2015,,,,44758,46016,1593,37458,3,38716,3
1595,41270,3,41635,2,365,2012,2013,,,,44920,45285,1595,37620,3,37985,2
1595,41635,2,42366,2,731,2013,2015,,,,45285,46016,1595,37985,2,38716,2
1596,39959,3,39982,3,23,2009,2009,,,,43609,43632,1596,36309,3,36332,3
1596,39982,3,40905,3,923,2009,2011,,,,43632,44555,1596,36332,3,37255,3
1596,40905,3,42366,3,1461,2011,2015,,,,44555,46016,1596,37255,3,38716,3
1597,39951,3,39954,3,3,2009,2009,,,,43601,43604,1597,36301,3,36304,3
1597,39954,3,40905,2,951,2009,2011,,,,43604,44555,1597,36304,3,37255,2
1598,39956,3,40174,3,218,2009,2009,,,,43606,43824,1598,36306,3,36524,3
1598,40174,3,42001,3,1827,2009,2014,,,,43824,45651,1598,36524,3,38351,3
1598,42001,3,42366,3,365,2014,2015,,,,45651,46016,1598,38351,3,38716,3
1599,40540,3,42366,3,1826,2010,2015,,,,44190,46016,1599,36890,3,38716,3
1600,39991,5,41421,4,1430,2009,2013,,,,43641,45071,1600,36341,5,37771,4
1600,41421,4,42366,4,945,2013,2015,,,,45071,46016,1600,37771,4,38716,4
1601,40012,5,42366,5,2354,2009,2015,,,,43662,46016,1601,36362,5,38716,5
1602,41848,6,42366,6,518,2014,2015,,,,45498,46016,1602,38198,6,38716,6
1604,41452,3,41778,4,326,2013,2014,,,,45102,45428,1604,37802,3,38128,4
1604,41778,4,42366,4,588,2014,2015,,,,45428,46016,1604,38128,4,38716,4
1605,40905,2,41087,3,182,2011,2012,,,,44555,44737,1605,37255,2,37437,3
1605,41087,3,42366,3,1279,2012,2015,,,,44737,46016,1605,37437,3,38716,3
1606,40743,3,41261,3,518,2011,2012,,,,44393,44911,1606,37093,3,37611,3
1606,41261,3,42366,3,1105,2012,2015,,,,44911,46016,1606,37611,3,38716,3
1607,42152,4,42366,4,214,2015,2015,,,,45802,46016,1607,38502,4,38716,4
1608,41412,2,42366,2,954,2013,2015,,,,45062,46016,1608,37762,2,38716,2
1610,41231,6,41443,6,212,2012,2013,,,,44881,45093,1610,37581,6,37793,6
1610,41443,6,42366,6,923,2013,2015,,,,45093,46016,1610,37793,6,38716,6
1612,40540,5,41148,5,608,2010,2012,,,,44190,44798,1612,36890,5,37498,5
1615,41056,4,42366,5,1310,2012,2015,,,,44706,46016,1615,37406,4,38716,5
1615,41056,5,42366,5,1310,2012,2015,,,,44706,46016,1615,37406,5,38716,5
1617,40814,4,42366,4,1552,2011,2015,,,,44464,46016,1617,37164,4,38716,4
1618,41270,4,41901,4,631,2012,2014,,,,44920,45551,1618,37620,4,38251,4
1618,41901,4,42275,5,374,2014,2015,,,,45551,45925,1618,38251,4,38625,5
1618,42275,5,42366,5,91,2015,2015,,,,45925,46016,1618,38625,5,38716,5
1619,40135,3,41047,4,912,2009,2012,,,,43785,44697,1619,36485,3,37397,4
1619,41047,4,42001,4,954,2012,2014,,,,44697,45651,1619,37397,4,38351,4
1619,42001,4,42149,5,148,2014,2015,,,,45651,45799,1619,38351,4,38499,5
1619,42149,5,42366,5,217,2015,2015,,,,45799,46016,1619,38499,5,38716,5
1620,41870,3,42366,3,496,2014,2015,,,,45520,46016,1620,38220,3,38716,3
1621,41635,2,42366,2,731,2013,2015,,,,45285,46016,1621,37985,2,38716,2
1622,40905,5,41635,6,730,2011,2013,,,,44555,45285,1622,37255,5,37985,6
1622,41635,6,42366,6,731,2013,2015,,,,45285,46016,1622,37985,6,38716,6
1623,40012,4,40322,5,310,2009,2010,,,,43662,43972,1623,36362,4,36672,5
1623,40322,5,40326,5,4,2010,2010,,,,43972,43976,1623,36672,5,36676,5
1623,40326,5,40540,6,214,2010,2010,,,,43976,44190,1623,36676,5,36890,6
1623,40540,6,41931,5,1391,2010,2014,,,,44190,45581,1623,36890,6,38281,5
1623,41931,5,42366,5,435,2014,2015,,,,45581,46016,1623,38281,5,38716,5
1625,39982,3,40440,3,458,2009,2010,,,,43632,44090,1625,36332,3,36790,3
1625,40440,3,41635,2,1195,2010,2013,,,,44090,45285,1625,36790,3,37985,2
1625,41635,2,42366,2,731,2013,2015,,,,45285,46016,1625,37985,2,38716,2
1626,39960,3,40416,3,456,2009,2010,,,,43610,44066,1626,36310,3,36766,3
1626,40416,3,41635,3,1219,2010,2013,,,,44066,45285,1626,36766,3,37985,3
1626,41635,3,42366,3,731,2013,2015,,,,45285,46016,1626,37985,3,38716,3
1628,41778,2,42366,2,588,2014,2015,,,,45428,46016,1628,38128,2,38716,2
1629,41055,3,41270,3,215,2012,2012,,,,44705,44920,1629,37405,3,37620,3
1629,41270,3,42366,3,1096,2012,2015,,,,44920,46016,1629,37620,3,38716,3
1630,40174,6,42001,5,1827,2009,2014,,,,43824,45651,1630,36524,6,38351,5
1630,42001,5,42366,5,365,2014,2015,,,,45651,46016,1630,38351,5,38716,5
1633,41270,3,42366,3,1096,2012,2015,,,,44920,46016,1633,37620,3,38716,3
1634,40144,6,40326,7,182,2009,2010,,,,43794,43976,1634,36494,6,36676,7
1635,39951,2,42366,2,2415,2009,2015,,,,43601,46016,1635,36301,2,38716,2
1636,41047,5,41056,6,9,2012,2012,,,,44697,44706,1636,37397,5,37406,6
1636,41056,6,42366,6,1310,2012,2015,,,,44706,46016,1636,37406,6,38716,6
1637,40691,8,40844,6,153,2011,2011,,,,44341,44494,1637,37041,8,37194,6
1637,40844,6,41787,7,943,2011,2014,,,,44494,45437,1637,37194,6,38137,7
1637,41787,7,42366,7,579,2014,2015,,,,45437,46016,1637,38137,7,38716,7
1638,41413,3,41910,2,497,2013,2014,,,,45063,45560,1638,37763,3,38260,2
1638,41910,2,42366,2,456,2014,2015,,,,45560,46016,1638,38260,2,38716,2
1639,40409,3,41447,3,1038,2010,2013,,,,44059,45097,1639,36759,3,37797,3
1639,41447,3,42366,3,919,2013,2015,,,,45097,46016,1639,37797,3,38716,3
1640,42213,2,42366,2,153,2015,2015,,,,45863,46016,1640,38563,2,38716,2
1641,40774,2,42244,2,1470,2011,2015,,,,44424,45894,1641,37124,2,38594,2
1641,42244,2,42366,2,122,2015,2015,,,,45894,46016,1641,38594,2,38716,2
1642,42143,2,42366,2,223,2015,2015,,,,45793,46016,1642,38493,2,38716,2
1643,41051,1,42366,1,1315,2012,2015,,,,44701,46016,1643,37401,1,38716,1
1644,40905,3,42366,3,1461,2011,2015,,,,44555,46016,1644,37255,3,38716,3
1646,40682,3,42366,3,1684,2011,2015,,,,44332,46016,1646,37032,3,38716,3
1647,42001,3,42366,3,365,2014,2015,,,,45651,46016,1647,38351,3,38716,3
1648,40689,5,41412,5,723,2011,2013,,,,44339,45062,1648,37039,5,37762,5
1648,41412,5,42001,4,589,2013,2014,,,,45062,45651,1648,37762,5,38351,4
1648,42001,4,42366,4,365,2014,2015,,,,45651,46016,1648,38351,4,38716,4
1649,40905,4,42366,4,1461,2011,2015,,,,44555,46016,1649,37255,4,38716,4
1650,41635,2,42001,1,366,2013,2014,,,,45285,45651,1650,37985,2,38351,1
1650,42001,1,42366,1,365,2014,2015,,,,45651,46016,1650,38351,1,38716,1
1651,41056,3,42366,3,1310,2012,2015,,,,44706,46016,1651,37406,3,38716,3
1652,40470,3,41139,2,669,2010,2012,,,,44120,44789,1652,36820,3,37489,2
1652,41139,2,42366,2,1227,2012,2015,,,,44789,46016,1652,37489,2,38716,2
1653,40357,2,41421,2,1064,2010,2013,,,,44007,45071,1653,36707,2,37771,2
1653,41421,2,41839,3,418,2013,2014,,,,45071,45489,1653,37771,2,38189,3
1653,41839,3,42366,3,527,2014,2015,,,,45489,46016,1653,38189,3,38716,3
1654,42143,4,42366,4,223,2015,2015,,,,45793,46016,1654,38493,4,38716,4
1656,40691,4,41056,4,365,2011,2012,,,,44341,44706,1656,37041,4,37406,4
1656,41056,4,41419,5,363,2012,2013,,,,44706,45069,1656,37406,4,37769,5
1656,41419,5,42366,5,947,2013,2015,,,,45069,46016,1656,37769,5,38716,5
1657,41056,3,41839,2,783,2012,2014,,,,44706,45489,1657,37406,3,38189,2
1657,41839,2,42366,2,527,2014,2015,,,,45489,46016,1657,38189,2,38716,2
1658,40905,4,42366,4,1461,2011,2015,,,,44555,46016,1658,37255,4,38716,4
1659,40326,2,41421,2,1095,2010,2013,,,,43976,45071,1659,36676,2,37771,2
1659,41421,2,41787,3,366,2013,2014,,,,45071,45437,1659,37771,2,38137,3
1659,41787,3,42366,3,579,2014,2015,,,,45437,46016,1659,38137,3,38716,3
1660,40691,7,41047,5,356,2011,2012,,,,44341,44697,1660,37041,7,37397,5
1660,41047,5,41600,4,553,2012,2013,,,,44697,45250,1660,37397,5,37950,4
1660,41600,4,41787,4,187,2013,2014,,,,45250,45437,1660,37950,4,38137,4
1660,41787,4,42366,4,579,2014,2015,,,,45437,46016,1660,38137,4,38716,4
1662,40440,3,41200,4,760,2010,2012,,,,44090,44850,1662,36790,3,37550,4
1662,41200,4,42366,4,1166,2012,2015,,,,44850,46016,1662,37550,4,38716,4
1663,40691,3,42366,3,1675,2011,2015,,,,44341,46016,1663,37041,3,38716,3
1664,39991,3,40104,4,113,2009,2009,,,,43641,43754,1664,36341,3,36454,4
1664,40104,4,41270,4,1166,2009,2012,,,,43754,44920,1664,36454,4,37620,4
1664,41270,4,41605,6,335,2012,2013,,,,44920,45255,1664,37620,4,37955,6
1664,41605,6,42366,6,761,2013,2015,,,,45255,46016,1664,37955,6,38716,6
1665,40135,4,41170,4,1035,2009,2012,,,,43785,44820,1665,36485,4,37520,4
1665,41170,4,41270,5,100,2012,2012,,,,44820,44920,1665,37520,4,37620,5
1665,41270,5,41412,7,142,2012,2013,,,,44920,45062,1665,37620,5,37762,7
1665,41412,7,42366,7,954,2013,2015,,,,45062,46016,1665,37762,7,38716,7
1666,40174,2,41452,2,1278,2009,2013,,,,43824,45102,1666,36524,2,37802,2
1666,41452,2,41787,3,335,2013,2014,,,,45102,45437,1666,37802,2,38137,3
1666,41787,3,41839,3,52,2014,2014,,,,45437,45489,1666,38137,3,38189,3
1666,41839,3,42366,3,527,2014,2015,,,,45489,46016,1666,38189,3,38716,3
1667,39960,2,41412,3,1452,2009,2013,,,,43610,45062,1667,36310,2,37762,3
1667,41412,3,41778,3,366,2013,2014,,,,45062,45428,1667,37762,3,38128,3
1667,41778,3,42366,3,588,2014,2015,,,,45428,46016,1667,38128,3,38716,3
1668,41635,3,42366,3,731,2013,2015,,,,45285,46016,1668,37985,3,38716,3
1669,42001,6,42366,6,365,2014,2015,,,,45651,46016,1669,38351,6,38716,6
1670,40074,4,41056,4,982,2009,2012,,,,43724,44706,1670,36424,4,37406,4
1670,41056,4,42366,4,1310,2012,2015,,,,44706,46016,1670,37406,4,38716,4
1671,40074,5,40479,4,405,2009,2010,,,,43724,44129,1671,36424,5,36829,4
1671,40479,4,41047,4,568,2010,2012,,,,44129,44697,1671,36829,4,37397,4
1671,41047,4,42366,4,1319,2012,2015,,,,44697,46016,1671,37397,4,38716,4
1672,40540,4,40682,4,142,2010,2011,,,,44190,44332,1672,36890,4,37032,4
1672,40682,4,41270,5,588,2011,2012,,,,44332,44920,1672,37032,4,37620,5
1672,41270,5,41605,6,335,2012,2013,,,,44920,45255,1672,37620,5,37955,6
1672,41605,6,41787,6,182,2013,2014,,,,45255,45437,1672,37955,6,38137,6
1672,41787,6,42366,6,579,2014,2015,,,,45437,46016,1672,38137,6,38716,6
1673,40021,3,42366,3,2345,2009,2015,,,,43671,46016,1673,36371,3,38716,3
1676,40174,2,41412,3,1238,2009,2013,,,,43824,45062,1676,36524,2,37762,3
1676,41412,3,41809,3,397,2013,2014,,,,45062,45459,1676,37762,3,38159,3
1676,41809,3,42366,3,557,2014,2015,,,,45459,46016,1676,38159,3,38716,3
1677,40174,2,41513,3,1339,2009,2013,,,,43824,45163,1677,36524,2,37863,3
1677,41513,3,41809,3,296,2013,2014,,,,45163,45459,1677,37863,3,38159,3
1677,41809,3,42366,3,557,2014,2015,,,,45459,46016,1677,38159,3,38716,3
1678,39951,3,42366,3,2415,2009,2015,,,,43601,46016,1678,36301,3,38716,3
1679,39991,2,41412,2,1421,2009,2013,,,,43641,45062,1679,36341,2,37762,2
1679,41412,2,41809,3,397,2013,2014,,,,45062,45459,1679,37762,2,38159,3
1679,41809,3,42001,3,192,2014,2014,,,,45459,45651,1679,38159,3,38351,3
1679,42001,3,42366,3,365,2014,2015,,,,45651,46016,1679,38351,3,38716,3
1680,40348,3,41421,4,1073,2010,2013,,,,43998,45071,1680,36698,3,37771,4
1680,41421,4,42366,4,945,2013,2015,,,,45071,46016,1680,37771,4,38716,4
1681,40752,4,41056,5,304,2011,2012,,,,44402,44706,1681,37102,4,37406,5
1681,41056,5,42366,5,1310,2012,2015,,,,44706,46016,1681,37406,5,38716,5
1682,40409,4,41047,5,638,2010,2012,,,,44059,44697,1682,36759,4,37397,5
1682,41047,5,41056,6,9,2012,2012,,,,44697,44706,1682,37397,5,37406,6
1682,41056,6,42366,6,1310,2012,2015,,,,44706,46016,1682,37406,6,38716,6
1682,41056,6,41839,6,783,2012,2014,,,,44706,45489,1682,37406,6,38189,6
1682,41839,6,42366,6,527,2014,2015,,,,45489,46016,1682,38189,6,38716,6
1684,40540,3,41270,4,730,2010,2012,,,,44190,44920,1684,36890,3,37620,4
1684,41270,4,42366,4,1096,2012,2015,,,,44920,46016,1684,37620,4,38716,4
1685,40174,5,40449,4,275,2009,2010,,,,43824,44099,1685,36524,5,36799,4
1685,40449,4,41209,4,760,2010,2012,,,,44099,44859,1685,36799,4,37559,4
1685,41209,4,42152,4,943,2012,2015,,,,44859,45802,1685,37559,4,38502,4
1685,42152,4,42366,4,214,2015,2015,,,,45802,46016,1685,38502,4,38716,4
1686,40905,1,42366,1,1461,2011,2015,,,,44555,46016,1686,37255,1,38716,1
1687,40540,2,42366,2,1826,2010,2015,,,,44190,46016,1687,36890,2,38716,2
1688,40387,3,42366,3,1979,2010,2015,,,,44037,46016,1688,36737,3,38716,3
1689,41787,3,42366,3,579,2014,2015,,,,45437,46016,1689,38137,3,38716,3
1690,39951,2,42366,2,2415,2009,2015,,,,43601,46016,1690,36301,2,38716,2
1691,40691,3,41818,3,1127,2011,2014,,,,44341,45468,1691,37041,3,38168,3
1691,41818,3,42366,3,548,2014,2015,,,,45468,46016,1691,38168,3,38716,3
1692,40021,3,40905,3,884,2009,2011,,,,43671,44555,1692,36371,3,37255,3
1692,40905,3,41931,2,1026,2011,2014,,,,44555,45581,1692,37255,3,38281,2
1692,41931,2,42366,2,435,2014,2015,,,,45581,46016,1692,38281,2,38716,2
1693,39951,3,40052,3,101,2009,2009,,,,43601,43702,1693,36301,3,36402,3
1694,40540,4,41047,4,507,2010,2012,,,,44190,44697,1694,36890,4,37397,4
1694,41047,4,42366,5,1319,2012,2015,,,,44697,46016,1694,37397,4,38716,5
1694,41047,5,42366,5,1319,2012,2015,,,,44697,46016,1694,37397,5,38716,5
1694,41047,5,41635,5,588,2012,2013,,,,44697,45285,1694,37397,5,37985,5
1697,41270,3,42366,3,1096,2012,2015,,,,44920,46016,1697,37620,3,38716,3
1699,41910,4,42366,4,456,2014,2015,,,,45560,46016,1699,38260,4,38716,4
1699,42366,4,42366,4,0,2015,2015,,,,46016,46016,1699,38716,4,38716,4
1700,40174,6,41056,6,882,2009,2012,,,,43824,44706,1700,36524,6,37406,6
1700,41056,6,42366,6,1310,2012,2015,,,,44706,46016,1700,37406,6,38716,6
1701,40174,3,40875,3,701,2009,2011,,,,43824,44525,1701,36524,3,37225,3
1701,40875,3,42366,3,1491,2011,2015,,,,44525,46016,1701,37225,3,38716,3
1703,41078,3,42366,3,1288,2012,2015,,,,44728,46016,1703,37428,3,38716,3
1704,39960,5,40174,5,214,2009,2009,,,,43610,43824,1704,36310,5,36524,5
1704,40174,5,41596,6,1422,2009,2013,,,,43824,45246,1704,36524,5,37946,6
1704,41596,6,42366,6,770,2013,2015,,,,45246,46016,1704,37946,6,38716,6
1706,41056,2,42366,2,1310,2012,2015,,,,44706,46016,1706,37406,2,38716,2
1707,41270,1,42366,1,1096,2012,2015,,,,44920,46016,1707,37620,1,38716,1
1708,40682,3,42366,3,1684,2011,2015,,,,44332,46016,1708,37032,3,38716,3
1709,39951,7,40074,7,123,2009,2009,,,,43601,43724,1709,36301,7,36424,7
1709,40905,8,42366,8,1461,2011,2015,,,,44555,46016,1709,37255,8,38716,8
1710,41270,3,42366,3,1096,2012,2015,,,,44920,46016,1710,37620,3,38716,3
1711,40326,3,42366,3,2040,2010,2015,,,,43976,46016,1711,36676,3,38716,3
1712,41270,3,41635,4,365,2012,2013,,,,44920,45285,1712,37620,3,37985,4
1713,40691,2,40805,3,114,2011,2011,,,,44341,44455,1713,37041,2,37155,3
1713,40805,3,41047,3,242,2011,2012,,,,44455,44697,1713,37155,3,37397,3
1713,41047,3,41056,5,9,2012,2012,,,,44697,44706,1713,37397,3,37406,5
1713,41056,5,41139,6,83,2012,2012,,,,44706,44789,1713,37406,5,37489,6
1713,41139,6,41179,4,40,2012,2012,,,,44789,44829,1713,37489,6,37529,4
1713,41179,4,41270,4,91,2012,2012,,,,44829,44920,1713,37529,4,37620,4
1713,41270,4,42001,5,731,2012,2014,,,,44920,45651,1713,37620,4,38351,5
1713,42001,5,42366,5,365,2014,2015,,,,45651,46016,1713,38351,5,38716,5
1714,40905,4,41872,4,967,2011,2014,,,,44555,45522,1714,37255,4,38222,4
1714,41872,4,42366,4,494,2014,2015,,,,45522,46016,1714,38222,4,38716,4
1715,39951,3,42001,3,2050,2009,2014,,,,43601,45651,1715,36301,3,38351,3
1715,42001,3,42366,3,365,2014,2015,,,,45651,46016,1715,38351,3,38716,3
1719,42001,3,42366,3,365,2014,2015,,,,45651,46016,1719,38351,3,38716,3
1720,42143,3,42366,3,223,2015,2015,,,,45793,46016,1720,38493,3,38716,3
1721,42143,3,42366,3,223,2015,2015,,,,45793,46016,1721,38493,3,38716,3
1722,39960,3,42366,3,2406,2009,2015,,,,43610,46016,1722,36310,3,38716,3
1723,39954,3,41962,3,2008,2009,2014,,,,43604,45612,1723,36304,3,38312,3
1723,41962,3,42366,3,404,2014,2015,,,,45612,46016,1723,38312,3,38716,3
1725,41971,5,42366,5,395,2014,2015,,,,45621,46016,1725,38321,5,38716,5
1726,41482,4,42001,3,519,2013,2014,,,,45132,45651,1726,37832,4,38351,3
1726,42001,3,42366,3,365,2014,2015,,,,45651,46016,1726,38351,3,38716,3
1727,41047,2,42366,2,1319,2012,2015,,,,44697,46016,1727,37397,2,38716,2
1728,40043,6,40113,5,70,2009,2009,,,,43693,43763,1728,36393,6,36463,5
1728,40113,5,40174,5,61,2009,2009,,,,43763,43824,1728,36463,5,36524,5
1728,40174,5,41910,5,1736,2009,2014,,,,43824,45560,1728,36524,5,38260,5
1728,41910,5,42366,5,456,2014,2015,,,,45560,46016,1728,38260,5,38716,5
1729,40470,2,42366,2,1896,2010,2015,,,,44120,46016,1729,36820,2,38716,2
1730,41087,3,41635,3,548,2012,2013,,,,44737,45285,1730,37437,3,37985,3
1730,41635,3,42366,3,731,2013,2015,,,,45285,46016,1730,37985,3,38716,3
1732,40174,7,40540,8,366,2009,2010,,,,43824,44190,1732,36524,7,36890,8
1732,40783,8,42366,8,1583,2011,2015,,,,44433,46016,1732,37133,8,38716,8
1734,40479,4,41473,4,994,2010,2013,,,,44129,45123,1734,36829,4,37823,4
1734,41473,4,42001,4,528,2013,2014,,,,45123,45651,1734,37823,4,38351,4
1734,42001,4,42366,4,365,2014,2015,,,,45651,46016,1734,38351,4,38716,4
1735,41047,6,41901,6,854,2012,2014,,,,44697,45551,1735,37397,6,38251,6
1735,41901,6,41962,6,61,2014,2014,,,,45551,45612,1735,38251,6,38312,6
1735,41962,6,42366,6,404,2014,2015,,,,45612,46016,1735,38312,6,38716,6
1736,39960,2,41056,1,1096,2009,2012,,,,43610,44706,1736,36310,2,37406,1
1736,41056,1,42366,1,1310,2012,2015,,,,44706,46016,1736,37406,1,38716,1
1737,40015,2,40317,2,302,2009,2010,,,,43665,43967,1737,36365,2,36667,2
1737,40317,2,41412,2,1095,2010,2013,,,,43967,45062,1737,36667,2,37762,2
1737,41412,2,42366,2,954,2013,2015,,,,45062,46016,1737,37762,2,38716,2
1738,40905,2,41940,2,1035,2011,2014,,,,44555,45590,1738,37255,2,38290,2
1738,41940,2,42366,2,426,2014,2015,,,,45590,46016,1738,38290,2,38716,2
1740,42001,4,42366,4,365,2014,2015,,,,45651,46016,1740,38351,4,38716,4
1741,41139,3,41574,4,435,2012,2013,,,,44789,45224,1741,37489,3,37924,4
1741,41574,4,41778,4,204,2013,2014,,,,45224,45428,1741,37924,4,38128,4
1741,41778,4,42366,4,588,2014,2015,,,,45428,46016,1741,38128,4,38716,4
1742,40814,3,41270,4,456,2011,2012,,,,44464,44920,1742,37164,3,37620,4
1742,41270,4,41785,5,515,2012,2014,,,,44920,45435,1742,37620,4,38135,5
1742,41785,5,42366,5,581,2014,2015,,,,45435,46016,1742,38135,5,38716,5
1744,40052,3,41270,3,1218,2009,2012,,,,43702,44920,1744,36402,3,37620,3
1744,41270,3,42366,3,1096,2012,2015,,,,44920,46016,1744,37620,3,38716,3
1745,40052,3,40540,3,488,2009,2010,,,,43702,44190,1745,36402,3,36890,3
1745,40540,3,40691,4,151,2010,2011,,,,44190,44341,1745,36890,3,37041,4
1745,40691,4,40743,4,52,2011,2011,,,,44341,44393,1745,37041,4,37093,4
1745,40743,4,41270,4,527,2011,2012,,,,44393,44920,1745,37093,4,37620,4
1745,41270,4,42152,4,882,2012,2015,,,,44920,45802,1745,37620,4,38502,4
1745,42152,4,42366,4,214,2015,2015,,,,45802,46016,1745,38502,4,38716,4
1746,40510,3,41421,4,911,2010,2013,,,,44160,45071,1746,36860,3,37771,4
1746,41421,4,42366,4,945,2013,2015,,,,45071,46016,1746,37771,4,38716,4
1748,40113,4,41054,4,941,2009,2012,,,,43763,44704,1748,36463,4,37404,4
1748,41054,4,42366,4,1312,2012,2015,,,,44704,46016,1748,37404,4,38716,4
1749,40682,3,40743,4,61,2011,2011,,,,44332,44393,1749,37032,3,37093,4
1749,40743,4,41047,4,304,2011,2012,,,,44393,44697,1749,37093,4,37397,4
1749,41047,4,42366,4,1319,2012,2015,,,,44697,46016,1749,37397,4,38716,4
1749,41047,4,41056,5,9,2012,2012,,,,44697,44706,1749,37397,4,37406,5
1749,41056,5,41938,5,882,2012,2014,,,,44706,45588,1749,37406,5,38288,5
1749,41938,5,42143,5,205,2014,2015,,,,45588,45793,1749,38288,5,38493,5
1749,42143,5,42366,4,223,2015,2015,,,,45793,46016,1749,38493,5,38716,4
1749,42143,4,42366,4,223,2015,2015,,,,45793,46016,1749,38493,4,38716,4
1750,40174,4,41078,5,904,2009,2012,,,,43824,44728,1750,36524,4,37428,5
1750,41078,5,41513,6,435,2012,2013,,,,44728,45163,1750,37428,5,37863,6
1750,41513,6,42366,6,853,2013,2015,,,,45163,46016,1750,37863,6,38716,6
1752,40174,5,41056,6,882,2009,2012,,,,43824,44706,1752,36524,5,37406,6
1752,41056,6,41270,6,214,2012,2012,,,,44706,44920,1752,37406,6,37620,6
1752,41270,6,42366,6,1096,2012,2015,,,,44920,46016,1752,37620,6,38716,6
1753,40691,2,42366,2,1675,2011,2015,,,,44341,46016,1753,37041,2,38716,2
1754,40470,3,42366,3,1896,2010,2015,,,,44120,46016,1754,36820,3,38716,3
1755,40774,2,42366,2,1592,2011,2015,,,,44424,46016,1755,37124,2,38716,2
1756,39991,5,40866,4,875,2009,2011,,,,43641,44516,1756,36341,5,37216,4
1756,40866,4,41782,4,916,2011,2014,,,,44516,45432,1756,37216,4,38132,4
1756,41782,4,42366,4,584,2014,2015,,,,45432,46016,1756,38132,4,38716,4
1757,40844,2,41419,3,575,2011,2013,,,,44494,45069,1757,37194,2,37769,3
1757,41419,3,41421,4,2,2013,2013,,,,45069,45071,1757,37769,3,37771,4
1757,41971,3,42366,3,395,2014,2015,,,,45621,46016,1757,38321,3,38716,3
1758,41263,4,41635,4,372,2012,2013,,,,44913,45285,1758,37613,4,37985,4
1758,41635,4,42366,4,731,2013,2015,,,,45285,46016,1758,37985,4,38716,4
1759,40317,3,42366,3,2049,2010,2015,,,,43967,46016,1759,36667,3,38716,3
1760,41047,5,41056,4,9,2012,2012,,,,44697,44706,1760,37397,5,37406,4
1760,41056,4,41412,4,356,2012,2013,,,,44706,45062,1760,37406,4,37762,4
1760,41412,4,42366,4,954,2013,2015,,,,45062,46016,1760,37762,4,38716,4
1761,41231,5,41443,6,212,2012,2013,,,,44881,45093,1761,37581,5,37793,6
1761,41443,6,41605,6,162,2013,2013,,,,45093,45255,1761,37793,6,37955,6
1761,41605,6,42366,6,761,2013,2015,,,,45255,46016,1761,37955,6,38716,6
1761,41605,6,42366,6,761,2013,2015,,,,45255,46016,1761,37955,6,38716,6
1762,40501,3,42366,3,1865,2010,2015,,,,44151,46016,1762,36851,3,38716,3
1763,41200,5,42366,5,1166,2012,2015,,,,44850,46016,1763,37550,5,38716,5
1764,41270,4,42366,4,1096,2012,2015,,,,44920,46016,1764,37620,4,38716,4
1765,40174,6,40418,6,244,2009,2010,,,,43824,44068,1765,36524,6,36768,6
1766,39951,3,40752,3,801,2009,2011,,,,43601,44402,1766,36301,3,37102,3
1766,40752,3,42366,3,1614,2011,2015,,,,44402,46016,1766,37102,3,38716,3
1767,40479,4,41635,4,1156,2010,2013,,,,44129,45285,1767,36829,4,37985,4
1767,41635,4,42366,4,731,2013,2015,,,,45285,46016,1767,37985,4,38716,4
1769,41504,5,42366,5,862,2013,2015,,,,45154,46016,1769,37854,5,38716,5
1770,40875,4,41412,4,537,2011,2013,,,,44525,45062,1770,37225,4,37762,4
1770,41412,4,41931,4,519,2013,2014,,,,45062,45581,1770,37762,4,38281,4
1770,41931,4,42366,4,435,2014,2015,,,,45581,46016,1770,38281,4,38716,4
1771,40326,3,42366,3,2040,2010,2015,,,,43976,46016,1771,36676,3,38716,3
1772,42001,4,42366,4,365,2014,2015,,,,45651,46016,1772,38351,4,38716,4
1773,40682,4,41421,4,739,2011,2013,,,,44332,45071,1773,37032,4,37771,4
1773,41421,4,42366,4,945,2013,2015,,,,45071,46016,1773,37771,4,38716,4
1774,40144,4,40540,3,396,2009,2010,,,,43794,44190,1774,36494,4,36890,3
1775,40021,4,40540,3,519,2009,2010,,,,43671,44190,1775,36371,4,36890,3
1776,40074,6,40113,6,39,2009,2009,,,,43724,43763,1776,36424,6,36463,6
1776,40113,6,40325,7,212,2009,2010,,,,43763,43975,1776,36463,6,36675,7
1776,40682,7,41209,8,527,2011,2012,,,,44332,44859,1776,37032,7,37559,8
1778,39960,3,40317,2,357,2009,2010,,,,43610,43967,1778,36310,3,36667,2
1779,40540,5,40743,4,203,2010,2011,,,,44190,44393,1779,36890,5,37093,4
1779,40743,4,42366,4,1623,2011,2015,,,,44393,46016,1779,37093,4,38716,4
1781,40348,6,42366,6,2018,2010,2015,,,,43998,46016,1781,36698,6,38716,6
1782,41992,3,42366,3,374,2014,2015,,,,45642,46016,1782,38342,3,38716,3
1783,41047,3,42366,3,1319,2012,2015,,,,44697,46016,1783,37397,3,38716,3
1785,40905,4,42366,4,1461,2011,2015,,,,44555,46016,1785,37255,4,38716,4
1786,41056,4,42366,5,1310,2012,2015,,,,44706,46016,1786,37406,4,38716,5
1786,41056,5,41270,6,214,2012,2012,,,,44706,44920,1786,37406,5,37620,6
1786,41270,6,41778,5,508,2012,2014,,,,44920,45428,1786,37620,6,38128,5
1786,41778,5,41787,5,9,2014,2014,,,,45428,45437,1786,38128,5,38137,5
1786,41787,5,42001,4,214,2014,2014,,,,45437,45651,1786,38137,5,38351,4
1786,42001,4,42366,4,365,2014,2015,,,,45651,46016,1786,38351,4,38716,4
1787,40174,3,41087,4,913,2009,2012,,,,43824,44737,1787,36524,3,37437,4
1787,41087,4,42366,4,1279,2012,2015,,,,44737,46016,1787,37437,4,38716,4
1788,40783,4,40905,3,122,2011,2011,,,,44433,44555,1788,37133,4,37255,3
1788,40905,3,41848,4,943,2011,2014,,,,44555,45498,1788,37255,3,38198,4
1788,41848,4,41870,3,22,2014,2014,,,,45498,45520,1788,38198,4,38220,3
1788,41870,3,42001,3,131,2014,2014,,,,45520,45651,1788,38220,3,38351,3
1788,42001,3,42366,3,365,2014,2015,,,,45651,46016,1788,38351,3,38716,3
1789,40691,4,41787,3,1096,2011,2014,,,,44341,45437,1789,37041,4,38137,3
1789,41787,3,42366,3,579,2014,2015,,,,45437,46016,1789,38137,3,38716,3
1790,39951,3,41901,3,1950,2009,2014,,,,43601,45551,1790,36301,3,38251,3
1790,41901,3,42366,3,465,2014,2015,,,,45551,46016,1790,38251,3,38716,3
1791,39951,7,40540,7,589,2009,2010,,,,43601,44190,1791,36301,7,36890,7
1792,40418,3,40835,4,417,2010,2011,,,,44068,44485,1792,36768,3,37185,4
1792,40835,4,41054,4,219,2011,2012,,,,44485,44704,1792,37185,4,37404,4
1792,41054,4,41778,5,724,2012,2014,,,,44704,45428,1792,37404,4,38128,5
1792,41778,5,42366,5,588,2014,2015,,,,45428,46016,1792,38128,5,38716,5
1793,41421,1,42366,1,945,2013,2015,,,,45071,46016,1793,37771,1,38716,1
1794,41416,1,42366,1,950,2013,2015,,,,45066,46016,1794,37766,1,38716,1
1795,41421,1,42366,1,945,2013,2015,,,,45071,46016,1795,37771,1,38716,1
1797,40174,3,40479,3,305,2009,2010,,,,43824,44129,1797,36524,3,36829,3
1797,40479,3,41270,2,791,2010,2012,,,,44129,44920,1797,36829,3,37620,2
1798,42152,2,42336,2,184,2015,2015,,,,45802,45986,1798,38502,2,38686,2
1798,42336,2,42366,2,30,2015,2015,,,,45986,46016,1798,38686,2,38716,2
1800,39960,3,41270,3,1310,2009,2012,,,,43610,44920,1800,36310,3,37620,3
1800,41270,3,42366,3,1096,2012,2015,,,,44920,46016,1800,37620,3,38716,3
1801,41778,3,42366,3,588,2014,2015,,,,45428,46016,1801,38128,3,38716,3
1802,41056,7,41270,4,214,2012,2012,,,,44706,44920,1802,37406,7,37620,4
1802,41270,4,42366,6,1096,2012,2015,,,,44920,46016,1802,37620,4,38716,6
1802,41270,6,41473,6,203,2012,2013,,,,44920,45123,1802,37620,6,37823,6
1802,41473,6,41635,6,162,2013,2013,,,,45123,45285,1802,37823,6,37985,6
1802,41635,6,42366,6,731,2013,2015,,,,45285,46016,1802,37985,6,38716,6
1803,39982,5,40174,6,192,2009,2009,,,,43632,43824,1803,36332,5,36524,6
1803,40174,6,40682,6,508,2009,2011,,,,43824,44332,1803,36524,6,37032,6
1803,40682,6,41473,7,791,2011,2013,,,,44332,45123,1803,37032,6,37823,7
1803,41473,7,42366,7,893,2013,2015,,,,45123,46016,1803,37823,7,38716,7
1804,41047,5,41056,4,9,2012,2012,,,,44697,44706,1804,37397,5,37406,4
1804,41056,4,41200,6,144,2012,2012,,,,44706,44850,1804,37406,4,37550,6
1804,41200,6,41412,6,212,2012,2013,,,,44850,45062,1804,37550,6,37762,6
1804,41412,6,41931,5,519,2013,2014,,,,45062,45581,1804,37762,6,38281,5
1804,41931,5,42366,5,435,2014,2015,,,,45581,46016,1804,38281,5,38716,5
1805,40326,6,41240,7,914,2010,2012,,,,43976,44890,1805,36676,6,37590,7
1805,41240,7,41421,8,181,2012,2013,,,,44890,45071,1805,37590,7,37771,8
1805,41421,8,41635,7,214,2013,2013,,,,45071,45285,1805,37771,8,37985,7
1805,41635,7,41787,7,152,2013,2014,,,,45285,45437,1805,37985,7,38137,7
1805,41787,7,41870,7,83,2014,2014,,,,45437,45520,1805,38137,7,38220,7
1805,41870,7,42366,7,496,2014,2015,,,,45520,46016,1805,38220,7,38716,7
1806,40174,4,42366,4,2192,2009,2015,,,,43824,46016,1806,36524,4,38716,4
1807,40326,7,42366,7,2040,2010,2015,,,,43976,46016,1807,36676,7,38716,7
1808,42001,6,42366,6,365,2014,2015,,,,45651,46016,1808,38351,6,38716,6
1809,41240,6,41416,7,176,2012,2013,,,,44890,45066,1809,37590,6,37766,7
1809,41416,7,42366,7,950,2013,2015,,,,45066,46016,1809,37766,7,38716,7
1810,39951,5,41270,6,1319,2009,2012,,,,43601,44920,1810,36301,5,37620,6
1810,41270,6,41778,5,508,2012,2014,,,,44920,45428,1810,37620,6,38128,5
1810,41778,5,42366,5,588,2014,2015,,,,45428,46016,1810,38128,5,38716,5
1812,40012,6,40682,6,670,2009,2011,,,,43662,44332,1812,36362,6,37032,6
1813,41270,3,42366,3,1096,2012,2015,,,,44920,46016,1813,37620,3,38716,3
1814,40470,2,42366,2,1896,2010,2015,,,,44120,46016,1814,36820,2,38716,2
1815,41270,3,42366,3,1096,2012,2015,,,,44920,46016,1815,37620,3,38716,3
1816,40835,5,41635,5,800,2011,2013,,,,44485,45285,1816,37185,5,37985,5
1816,41635,5,42366,5,731,2013,2015,,,,45285,46016,1816,37985,5,38716,5
1818,41047,2,42366,2,1319,2012,2015,,,,44697,46016,1818,37397,2,38716,2
1819,39951,4,40682,4,731,2009,2011,,,,43601,44332,1819,36301,4,37032,4
1819,40682,4,41231,4,549,2011,2012,,,,44332,44881,1819,37032,4,37581,4
1819,41231,4,42001,4,770,2012,2014,,,,44881,45651,1819,37581,4,38351,4
1819,42001,4,42366,4,365,2014,2015,,,,45651,46016,1819,38351,4,38716,4
1821,42143,5,42366,5,223,2015,2015,,,,45793,46016,1821,38493,5,38716,5
1822,40540,4,42366,4,1826,2010,2015,,,,44190,46016,1822,36890,4,38716,4
1823,41056,4,42366,5,1310,2012,2015,,,,44706,46016,1823,37406,4,38716,5
1823,41056,5,41209,4,153,2012,2012,,,,44706,44859,1823,37406,5,37559,4
1823,41209,4,42001,4,792,2012,2014,,,,44859,45651,1823,37559,4,38351,4
1823,42001,4,42366,4,365,2014,2015,,,,45651,46016,1823,38351,4,38716,4
1824,40686,2,42366,2,1680,2011,2015,,,,44336,46016,1824,37036,2,38716,2
1826,42275,2,42366,2,91,2015,2015,,,,45925,46016,1826,38625,2,38716,2
1829,40174,4,40418,3,244,2009,2010,,,,43824,44068,1829,36524,4,36768,3
