id,start.date,start.rating,end.date,end.rating,time,start.year,end.year,,
1,36891,6,38716,6,1825,2000,2005,,1999
2,37762,6,38716,6,954,2003,2005,,2005
3,36524,5,36829,6,305,1999,2000,,
3,36829,6,37255,5,426,2000,2001,,
3,37255,5,38716,5,1461,2001,2005,,
4,37255,5,37406,6,151,2001,2002,,
4,37406,6,38716,6,1310,2002,2005,,
5,36670,2,37041,3,371,2000,2001,,
5,37041,3,37194,2,153,2001,2001,,
5,37194,2,38716,2,1522,2001,2005,,
6,36524,4,37255,4,731,1999,2001,,
6,37255,4,38716,4,1461,2001,2005,,
7,37620,4,37795,5,175,2002,2003,,
7,37795,5,37985,6,190,2003,2003,,
7,37985,6,38128,5,143,2003,2004,,
7,38128,5,38716,5,588,2004,2005,,
8,37620,3,38716,3,1096,2002,2005,,
10,38351,5,38716,5,365,2004,2005,,
11,36524,6,37255,7,731,1999,2001,,
11,37255,7,37397,8,142,2001,2002,,
13,36524,4,37771,5,1247,1999,2003,,
13,37771,5,38716,5,945,2003,2005,,
14,36424,5,36524,5,100,1999,1999,,
14,36524,5,37255,5,731,1999,2001,,
14,37255,5,37402,6,147,2001,2002,,
14,37402,6,38128,5,726,2002,2004,,
14,38128,5,38716,5,588,2004,2005,,
15,37985,4,38716,4,731,2003,2005,,
17,36341,3,38716,3,2375,1999,2005,,
18,36332,6,38160,6,1828,1999,2004,,
18,38160,6,38716,6,556,2004,2005,,
20,36890,5,37102,6,212,2000,2001,,
20,37102,6,38716,6,1614,2001,2005,,
21,36698,2,38716,2,2018,2000,2005,,
22,38351,8,38716,8,365,2004,2005,,
23,36310,5,38594,5,2284,1999,2005,,
23,38594,5,38716,5,122,2005,2005,,
25,36676,4,36790,3,114,2000,2000,,
25,36790,3,38716,3,1926,2000,2005,,
26,36524,4,38128,4,1604,1999,2004,,
26,38128,4,38716,4,588,2004,2005,,
27,38137,2,38716,2,579,2004,2005,,
28,38351,4,38716,4,365,2004,2005,,
29,36860,3,38716,3,1856,2000,2005,,
30,37255,1,37762,3,507,2001,2003,,
30,37762,3,37985,5,223,2003,2003,,
32,37885,3,38716,3,831,2003,2005,,
34,36676,2,37620,3,944,2000,2002,,
34,37620,3,37771,3,151,2002,2003,,
34,37771,3,38716,3,945,2003,2005,,
35,37620,3,38220,3,600,2002,2004,,
35,38220,3,38716,3,496,2004,2005,,
36,36676,4,38716,4,2040,2000,2005,,
37,38351,2,38716,2,365,2004,2005,,
38,36890,3,37924,3,1034,2000,2003,,
38,37924,3,38716,3,792,2003,2005,,
39,36667,2,37399,1,732,2000,2002,,
39,37399,1,38716,1,1317,2002,2005,,
40,36494,3,37976,3,1482,1999,2003,,
40,37976,3,37985,3,9,2003,2003,,
40,37985,3,38716,3,731,2003,2005,,
42,38168,3,38716,3,548,2004,2005,,
43,37041,3,37063,4,22,2001,2001,,
43,37063,4,37397,4,334,2001,2002,,
43,37397,4,38716,5,1319,2002,2005,,
43,37397,5,37406,6,9,2002,2002,,
43,37406,6,38220,5,814,2002,2004,,
43,38220,5,38502,5,282,2004,2005,,
43,38502,5,38716,5,214,2005,2005,,
44,38502,4,38716,4,214,2005,2005,,
45,37406,1,38716,1,1310,2002,2005,,
46,36310,2,37133,2,823,1999,2001,,
46,37133,2,37620,2,487,2001,2002,,
46,37620,2,37985,3,365,2002,2003,,
46,37985,3,38716,3,731,2003,2005,,
47,37620,4,37771,4,151,2002,2003,,
47,37771,4,38716,4,945,2003,2005,,
48,36310,4,38716,4,2406,1999,2005,,
49,37406,2,38716,2,1310,2002,2005,,
50,36668,3,38716,3,2048,2000,2005,,
52,36494,4,36515,4,21,1999,1999,,
52,36515,4,37406,3,891,1999,2002,,
52,37406,3,38716,3,1310,2002,2005,,
53,36676,2,38716,2,2040,2000,2005,,
54,36881,6,37194,7,313,2000,2001,,
54,37194,7,37467,8,273,2001,2002,,
56,37406,5,37771,6,365,2002,2003,,
56,37771,6,38716,6,945,2003,2005,,
57,36310,3,37032,3,722,1999,2001,,
58,38159,2,38716,2,557,2004,2005,,
59,38137,4,38716,4,579,2004,2005,,
60,36369,5,36860,5,491,1999,2000,,
61,36765,4,38716,4,1951,2000,2005,,
62,36301,3,37985,3,1684,1999,2003,,
62,37985,3,38716,3,731,2003,2005,,
63,36433,3,37771,3,1338,1999,2003,,
63,37771,3,38716,3,945,2003,2005,,
64,37467,5,37771,4,304,2002,2003,,
64,37771,4,38716,4,945,2003,2005,,
65,36667,5,37041,5,374,2000,2001,,
65,37041,5,37620,4,579,2001,2002,,
65,37620,4,38137,4,517,2002,2004,,
65,38137,4,38716,4,579,2004,2005,,
66,38168,4,38716,4,548,2004,2005,,
67,36676,3,37771,3,1095,2000,2003,,
67,37771,3,38168,4,397,2003,2004,,
67,38168,4,38290,4,122,2004,2004,,
67,38290,4,38351,4,61,2004,2004,,
67,38351,4,38716,4,365,2004,2005,,
68,38225,4,38716,4,491,2004,2005,,
69,36829,3,38716,3,1887,2000,2005,,
70,36707,3,37559,4,852,2000,2002,,
70,37559,4,38716,4,1157,2002,2005,,
71,38351,4,38716,4,365,2004,2005,,
72,36304,4,37397,4,1093,1999,2002,,
72,37397,4,38716,4,1319,2002,2005,,
73,36310,5,36890,5,580,1999,2000,,
73,36890,5,37620,4,730,2000,2002,,
73,37620,4,38716,4,1096,2002,2005,,
74,36369,5,36676,5,307,1999,2000,,
74,36676,5,37406,4,730,2000,2002,,
74,37406,4,38716,4,1310,2002,2005,,
75,36463,3,37771,3,1308,1999,2003,,
75,37771,3,38716,3,945,2003,2005,,
76,37406,3,37823,3,417,2002,2003,,
77,37102,4,37894,6,792,2001,2003,,
77,37894,6,37985,6,91,2003,2003,,
77,37985,6,38716,6,731,2003,2005,,
78,37620,1,38716,1,1096,2002,2005,,
79,38137,2,38716,2,579,2004,2005,,
81,37255,3,37437,4,182,2001,2002,,
81,37437,4,38716,4,1279,2002,2005,,
82,37072,4,37762,4,690,2001,2003,,
82,37762,4,38716,4,954,2003,2005,,
83,36301,5,36524,5,223,1999,1999,,
83,36524,5,37216,6,692,1999,2001,,
83,37216,6,37397,6,181,2001,2002,,
83,37397,6,38716,6,1319,2002,2005,,
85,38351,4,38716,4,365,2004,2005,,
86,36881,5,37985,5,1104,2000,2003,,
86,37985,5,38137,6,152,2003,2004,,
86,38137,6,38716,6,579,2004,2005,,
87,37520,3,38716,3,1196,2002,2005,,
88,36301,5,37032,5,731,1999,2001,,
88,37032,5,38716,5,1684,2001,2005,,
89,37133,4,38716,4,1583,2001,2005,,
91,36524,2,37771,3,1247,1999,2003,,
92,36301,5,37915,5,1614,1999,2003,,
92,37915,5,38351,4,436,2003,2004,,
92,38351,4,38716,4,365,2004,2005,,
93,37428,4,38351,4,923,2002,2004,,
93,38351,4,38716,4,365,2004,2005,,
94,36676,4,38716,4,2040,2000,2005,,
95,38502,4,38716,4,214,2005,2005,,
96,36890,3,38716,3,1826,2000,2005,,
97,37063,5,37164,4,101,2001,2001,,
97,37164,4,38351,5,1187,2001,2004,,
97,38351,5,38716,5,365,2004,2005,,
98,37400,3,38716,3,1316,2002,2005,,
100,36301,4,36860,4,559,1999,2000,,
100,36860,4,37985,3,1125,2000,2003,,
100,37985,3,38716,3,731,2003,2005,,
101,37620,3,38716,3,1096,2002,2005,,
105,36524,3,38716,3,2192,1999,2005,,
106,37529,4,37771,6,242,2002,2003,,
106,37771,6,37955,5,184,2003,2003,,
106,37955,5,38716,5,761,2003,2005,,
107,36301,4,37032,4,731,1999,2001,,
107,37032,4,38716,4,1684,2001,2005,,
108,36524,3,37985,3,1461,1999,2003,,
108,37985,3,38716,3,731,2003,2005,,
110,36676,3,38716,3,2040,2000,2005,,
111,37255,2,38716,2,1461,2001,2005,,
111,37255,2,38716,2,1461,2001,2005,,
112,38351,5,38716,5,365,2004,2005,,
113,36310,4,37032,4,722,1999,2001,,
113,37032,4,38716,4,1684,2001,2005,,
114,37620,3,38716,3,1096,2002,2005,,
115,36341,3,37985,3,1644,1999,2003,,
115,37985,3,38716,3,731,2003,2005,,
116,36310,4,36675,3,365,1999,2000,,
116,36675,3,38137,3,1462,2000,2004,,
116,38137,3,38716,3,579,2004,2005,,
117,36310,4,36728,3,418,1999,2000,,
117,36728,3,38716,3,1988,2000,2005,,
118,38493,3,38716,4,223,2005,2005,,
118,38493,4,38716,4,223,2005,2005,,
120,36301,4,36524,4,223,1999,1999,,
120,36524,4,38716,4,2192,1999,2005,,
121,38251,4,38716,4,465,2004,2005,,
122,36705,3,37915,2,1210,2000,2003,,
122,37915,2,38716,2,801,2003,2005,,
123,37771,3,38128,3,357,2003,2004,,
123,38128,3,38716,3,588,2004,2005,,
124,36424,3,38716,3,2292,1999,2005,,
125,36524,2,38716,2,2192,1999,2005,,
126,37406,5,38198,4,792,2002,2004,,
126,38198,4,38716,4,518,2004,2005,,
127,36463,5,36524,5,61,1999,1999,,
127,36524,5,38716,6,2192,1999,2005,,
127,36524,6,38198,5,1674,1999,2004,,
127,38198,5,38716,5,518,2004,2005,,
128,36494,2,37620,3,1126,1999,2002,,
129,38128,3,38716,3,588,2004,2005,,
132,36890,3,37032,3,142,2000,2001,,
132,37032,3,38716,3,1684,2001,2005,,
134,36308,2,36668,2,360,1999,2000,,
134,36668,2,38136,2,1468,2000,2004,,
134,38136,2,38716,2,580,2004,2005,,
135,36676,3,37063,3,387,2000,2001,,
135,37063,3,38716,3,1653,2001,2005,,
137,37035,4,38716,4,1681,2001,2005,,
139,36524,3,37041,4,517,1999,2001,,
139,37041,4,38716,4,1675,2001,2005,,
140,38502,3,38716,3,214,2005,2005,,
142,37255,5,38137,4,882,2001,2004,,
142,38137,4,38716,4,579,2004,2005,,
143,36524,4,36676,3,152,1999,2000,,
143,36676,3,37489,3,813,2000,2002,,
143,37489,3,38716,3,1227,2002,2005,,
144,37762,4,38716,4,954,2003,2005,,
145,36676,3,38716,3,2040,2000,2005,,
146,37072,1,38716,1,1644,2001,2005,,
148,36667,3,38716,3,2049,2000,2005,,
149,37559,4,37985,3,426,2002,2003,,
149,37985,3,38716,3,731,2003,2005,,
150,37037,2,37072,2,35,2001,2001,,
150,37072,2,38135,2,1063,2001,2004,,
150,38135,2,38716,2,581,2004,2005,,
152,37771,2,38716,2,945,2003,2005,,
153,36860,4,38716,4,1856,2000,2005,,
154,37406,1,38716,1,1310,2002,2005,,
155,37863,4,38716,4,853,2003,2005,,
156,36524,6,36667,7,143,1999,2000,,
156,36667,7,36676,6,9,2000,2000,,
156,36676,6,37771,7,1095,2000,2003,,
156,37771,7,38137,6,366,2003,2004,,
156,38137,6,38321,6,184,2004,2004,,
156,38321,6,38716,6,395,2004,2005,,
157,37489,3,37581,3,92,2002,2002,,
157,37581,3,37985,3,404,2002,2003,,
160,37032,2,37985,3,953,2001,2003,,
160,37985,3,38716,3,731,2003,2005,,
161,36308,6,36728,6,420,1999,2000,,
161,36728,6,37397,7,669,2000,2002,,
161,37620,6,38716,7,1096,2002,2005,,
161,37620,7,38716,7,1096,2002,2005,,
162,36310,6,36457,6,147,1999,1999,,
162,36457,6,38716,6,2259,1999,2005,,
163,37620,3,38716,3,1096,2002,2005,,
165,37406,6,37863,7,457,2002,2003,,
165,37863,7,38137,6,274,2003,2004,,
165,38137,6,38716,6,579,2004,2005,,
166,36799,3,37620,3,821,2000,2002,,
166,37620,3,38716,4,1096,2002,2005,,
166,37620,4,38716,5,1096,2002,2005,,
166,37620,5,37985,5,365,2002,2003,,
166,37985,5,38716,5,731,2003,2005,,
167,36301,4,38168,3,1867,1999,2004,,
167,38168,3,38716,3,548,2004,2005,,
168,38220,4,38716,4,496,2004,2005,,
169,36676,2,36799,2,123,2000,2000,,
169,36799,2,38716,2,1917,2000,2005,,
170,37041,3,37255,3,214,2001,2001,,
170,37255,3,37793,4,538,2001,2003,,
170,37793,4,38351,5,558,2003,2004,,
171,36676,3,38351,3,1675,2000,2004,,
171,38351,3,38716,3,365,2004,2005,,
172,37915,3,38716,3,801,2003,2005,,
173,37255,2,37406,3,151,2001,2002,,
173,38168,2,38716,2,548,2004,2005,,
175,38351,4,38716,4,365,2004,2005,,
176,36341,5,36667,5,326,1999,2000,,
176,36667,5,37406,4,739,2000,2002,,
177,38493,2,38502,2,9,2005,2005,,
177,38502,2,38716,2,214,2005,2005,,
180,38497,2,38716,2,219,2005,2005,,
181,38198,4,38493,3,295,2004,2005,,
181,38493,3,38716,3,223,2005,2005,,
182,37032,3,37985,3,953,2001,2003,,
182,37985,3,38716,3,731,2003,2005,,
184,37771,3,38716,3,945,2003,2005,,
185,38189,3,38716,3,527,2004,2005,,
187,36762,2,37924,2,1162,2000,2003,,
187,37924,2,38716,2,792,2003,2005,,
188,36890,3,38716,3,1826,2000,2005,,
189,37467,4,38716,4,1249,2002,2005,,
191,37406,3,37559,4,153,2002,2002,,
191,37559,4,37620,4,61,2002,2002,,
191,37620,4,38716,5,1096,2002,2005,,
191,37620,5,38716,5,1096,2002,2005,,
192,36707,3,37032,3,325,2000,2001,,
192,37032,3,38716,3,1684,2001,2005,,
194,37559,3,37762,3,203,2002,2003,,
194,37762,3,38716,3,954,2003,2005,,
195,36890,4,37559,4,669,2000,2002,,
195,37559,4,38502,4,943,2002,2005,,
195,38502,4,38716,4,214,2005,2005,,
197,37985,2,38716,2,731,2003,2005,,
198,36523,4,37771,5,1248,1999,2003,,
198,37771,5,38716,5,945,2003,2005,,
200,36310,4,38716,4,2406,1999,2005,,
201,38351,4,38716,4,365,2004,2005,,
202,36332,5,36424,5,92,1999,1999,,
202,36424,5,37255,5,831,1999,2001,,
202,37255,5,38716,5,1461,2001,2005,,
203,37771,6,38137,6,366,2003,2004,,
203,38137,6,38716,6,579,2004,2005,,
204,37124,3,37406,3,282,2001,2002,,
204,37406,3,38716,4,1310,2002,2005,,
204,37406,4,37489,6,83,2002,2002,,
204,37489,6,37520,5,31,2002,2002,,
204,37520,5,37620,4,100,2002,2002,,
206,36698,4,37102,4,404,2000,2001,,
206,37102,4,38290,5,1188,2001,2004,,
206,38290,5,38716,5,426,2004,2005,,
208,37428,6,37529,6,101,2002,2002,,
208,37529,6,37620,5,91,2002,2002,,
208,37620,5,38716,5,1096,2002,2005,,
211,36368,2,37032,2,664,1999,2001,,
211,37032,2,37985,2,953,2001,2003,,
211,37985,2,38716,2,731,2003,2005,,
212,38351,4,38716,4,365,2004,2005,,
213,37406,4,38716,4,1310,2002,2005,,
214,36310,4,37559,4,1249,1999,2002,,
214,37559,4,38716,4,1157,2002,2005,,
215,37397,3,38716,3,1319,2002,2005,,
216,36301,2,37620,1,1319,1999,2002,,
216,37620,1,38716,1,1096,2002,2005,,
219,37955,3,38716,3,761,2003,2005,,
220,36768,4,38716,4,1948,2000,2005,,
221,36524,4,38716,4,2192,1999,2005,,
222,36790,3,37793,3,1003,2000,2003,,
222,37793,3,38716,3,923,2003,2005,,
223,37458,4,38716,4,1258,2002,2005,,
224,36829,5,37255,5,426,2000,2001,,
224,37255,5,37894,6,639,2001,2003,,
224,37894,6,38168,6,274,2003,2004,,
224,38168,6,38716,6,548,2004,2005,,
226,36310,4,38351,3,2041,1999,2004,,
227,37985,3,38716,3,731,2003,2005,,
229,36890,3,37032,3,142,2000,2001,,
229,37032,3,38716,3,1684,2001,2005,,
230,37590,4,37620,4,30,2002,2002,,
230,37620,4,38342,3,722,2002,2004,,
230,38342,3,38716,3,374,2004,2005,,
231,37255,3,37771,4,516,2001,2003,,
231,37771,4,38128,4,357,2003,2004,,
231,38128,4,38716,4,588,2004,2005,,
231,38716,4,38716,4,0,2005,2005,,
232,36524,3,38716,3,2192,1999,2005,,
233,37041,4,38716,4,1675,2001,2005,,
234,36829,2,38716,2,1887,2000,2005,,
235,36524,4,38716,4,2192,1999,2005,,
237,36890,3,38716,3,1826,2000,2005,,
238,36676,3,37032,3,356,2000,2001,,
238,37032,3,37255,3,223,2001,2001,,
238,37255,3,38716,3,1461,2001,2005,,
239,37032,3,37620,3,588,2001,2002,,
239,37620,3,38716,3,1096,2002,2005,,
241,36301,5,36729,4,428,1999,2000,,
241,36729,4,37185,4,456,2000,2001,,
241,37185,4,37620,3,435,2001,2002,,
241,37620,3,38716,3,1096,2002,2005,,
242,37520,5,38351,3,831,2002,2004,,
242,38351,3,38716,3,365,2004,2005,,
243,36667,3,38351,3,1684,2000,2004,,
243,38351,3,38716,3,365,2004,2005,,
244,36301,4,38281,3,1980,1999,2004,,
244,38281,3,38716,3,435,2004,2005,,
246,36676,3,37124,4,448,2000,2001,,
246,37124,4,37467,4,343,2001,2002,,
247,36301,3,37124,4,823,1999,2001,,
247,37124,4,37255,3,131,2001,2001,,
247,37255,3,37401,4,146,2001,2002,,
247,37401,4,38716,4,1315,2002,2005,,
248,37032,4,38716,5,1684,2001,2005,,
248,37032,5,38716,5,1684,2001,2005,,
248,37032,5,37620,5,588,2001,2002,,
248,37620,5,37762,6,142,2002,2003,,
248,37762,6,38533,5,771,2003,2005,,
248,38533,5,38716,5,183,2005,2005,,
249,37216,5,37529,6,313,2001,2002,,
249,37529,6,37771,6,242,2002,2003,,
249,37771,6,38716,6,945,2003,2005,,
250,37255,4,38716,4,1461,2001,2005,,
251,36301,6,36881,6,580,1999,2000,,
251,36881,6,37041,6,160,2000,2001,,
251,37041,6,38290,6,1249,2001,2004,,
251,38290,6,38351,6,61,2004,2004,,
251,38351,6,38716,6,365,2004,2005,,
252,36890,4,37590,4,700,2000,2002,,
252,37590,4,38716,4,1126,2002,2005,,
253,36667,5,38716,5,2049,2000,2005,,
254,37124,6,37771,6,647,2001,2003,,
254,37771,6,38716,6,945,2003,2005,,
255,37041,5,37955,6,914,2001,2003,,
255,37955,6,38716,6,761,2003,2005,,
256,36301,3,37041,4,740,1999,2001,,
256,37041,4,38716,4,1675,2001,2005,,
257,37185,4,37985,4,800,2001,2003,,
257,37985,4,38229,4,244,2003,2004,,
257,38229,4,38655,5,426,2004,2005,,
257,38655,5,38716,5,61,2005,2005,,
258,37102,3,38716,3,1614,2001,2005,,
259,36524,5,36890,5,366,1999,2000,,
259,36890,5,37255,6,365,2000,2001,,
259,37255,6,38130,5,875,2001,2004,,
259,38130,5,38716,5,586,2004,2005,,
261,37406,3,37771,4,365,2002,2003,,
261,37771,4,37985,4,214,2003,2003,,
261,37985,4,38716,4,731,2003,2005,,
262,36829,2,37620,1,791,2000,2002,,
262,37620,1,38716,1,1096,2002,2005,,
263,37397,5,37590,6,193,2002,2002,,
263,37590,6,38716,6,1126,2002,2005,,
264,36667,3,37063,4,396,2000,2001,,
264,37063,4,38655,5,1592,2001,2005,,
264,38655,5,38716,5,61,2005,2005,,
265,36667,8,38716,8,2049,2000,2005,,
266,36667,4,37071,4,404,2000,2001,,
266,37071,4,37437,3,366,2001,2002,,
266,37437,3,38716,3,1279,2002,2005,,
267,38137,3,38716,3,579,2004,2005,,
268,36370,6,37072,7,702,1999,2001,,
269,36667,4,37493,6,826,2000,2002,,
269,37493,6,37520,5,27,2002,2002,,
269,37520,5,37771,6,251,2002,2003,,
269,37771,6,38493,6,722,2003,2005,,
269,38493,6,38716,6,223,2005,2005,,
270,37428,5,37985,5,557,2002,2003,,
270,37985,5,38716,5,731,2003,2005,,
271,36890,3,37102,2,212,2000,2001,,
271,37102,2,38716,2,1614,2001,2005,,
272,37032,3,37397,4,365,2001,2002,,
272,37397,4,38716,4,1319,2002,2005,,
273,37041,4,37762,5,721,2001,2003,,
273,37762,5,37771,4,9,2003,2003,,
273,37771,4,38128,5,357,2003,2004,,
273,38128,5,38716,5,588,2004,2005,,
274,37164,3,38716,3,1552,2001,2005,,
275,36341,2,38716,2,2375,1999,2005,,
276,36310,2,38716,2,2406,1999,2005,,
277,38498,2,38716,2,218,2005,2005,,
279,36768,5,37032,4,264,2000,2001,,
280,37185,4,37406,4,221,2001,2002,,
280,37406,4,37894,4,488,2002,2003,,
280,37894,4,37985,5,91,2003,2003,,
280,37985,5,38133,6,148,2003,2004,,
280,38133,6,38716,6,583,2004,2005,,
281,36301,5,36890,4,589,1999,2000,,
281,36890,4,37124,4,234,2000,2001,,
282,37255,3,38716,3,1461,2001,2005,,
283,36890,3,37032,4,142,2000,2001,,
283,37032,4,37406,4,374,2001,2002,,
283,37406,4,37620,5,214,2002,2002,,
283,37620,5,37762,6,142,2002,2003,,
283,37762,6,38493,6,731,2003,2005,,
283,38493,6,38716,6,223,2005,2005,,
285,36524,6,38716,6,2192,1999,2005,,
286,37124,3,38716,3,1592,2001,2005,,
287,37032,3,37397,4,365,2001,2002,,
287,37397,4,38716,4,1319,2002,2005,,
288,37032,3,38716,3,1684,2001,2005,,
289,37590,3,38716,3,1126,2002,2005,,
290,37946,4,38716,4,770,2003,2005,,
291,37255,1,38716,1,1461,2001,2005,,
292,36463,4,37164,4,701,1999,2001,,
293,36332,4,37559,4,1227,1999,2002,,
293,37559,4,37985,4,426,2002,2003,,
293,37985,4,38129,5,144,2003,2004,,
293,38129,5,38716,5,587,2004,2005,,
294,37489,5,38716,7,1227,2002,2005,,
294,37489,7,37520,5,31,2002,2002,,
295,37041,6,37093,7,52,2001,2001,,
295,37093,7,38716,8,1623,2001,2005,,
295,37093,8,37985,7,892,2001,2003,,
295,37985,7,38128,7,143,2003,2004,,
295,38128,7,38716,7,588,2004,2005,,
296,37255,6,37406,6,151,2001,2002,,
296,37406,6,37768,7,362,2002,2003,,
296,37768,7,38716,7,948,2003,2005,,
300,38502,4,38716,4,214,2005,2005,,
301,37225,4,37620,4,395,2001,2002,,
301,37620,4,37802,4,182,2002,2003,,
301,37802,4,38716,4,914,2003,2005,,
303,37915,5,38251,5,336,2003,2004,,
303,38251,5,38716,5,465,2004,2005,,
304,37225,2,37255,1,30,2001,2001,,
304,37255,1,38502,2,1247,2001,2005,,
304,38502,2,38716,2,214,2005,2005,,
304,38502,2,38716,2,214,2005,2005,,
305,37072,4,37133,4,61,2001,2001,,
305,37133,4,37255,5,122,2001,2001,,
305,37255,5,37401,5,146,2001,2002,,
305,37401,5,38716,5,1315,2002,2005,,
306,36310,4,38716,4,2406,1999,2005,,
307,37771,3,38716,3,945,2003,2005,,
308,38502,2,38716,2,214,2005,2005,,
308,38502,2,38716,2,214,2005,2005,,
312,36371,6,38716,6,2345,1999,2005,,
313,37458,2,37771,3,313,2002,2003,,
313,37771,3,38716,3,945,2003,2005,,
314,36457,7,38716,7,2259,1999,2005,,
315,38493,5,38716,5,223,2005,2005,,
316,38312,4,38716,4,404,2004,2005,,
317,37041,8,37064,6,23,2001,2001,,
317,37064,6,37255,7,191,2001,2001,,
317,37255,7,38716,7,1461,2001,2005,,
318,36890,5,38351,4,1461,2000,2004,,
318,38351,4,38716,4,365,2004,2005,,
319,37863,4,38716,4,853,2003,2005,,
320,36371,7,36524,7,153,1999,1999,,
322,36301,3,37102,4,801,1999,2001,,
322,37102,4,37826,4,724,2001,2003,,
322,37826,4,38716,4,890,2003,2005,,
323,36494,3,36676,3,182,1999,2000,,
323,36676,3,37041,3,365,2000,2001,,
323,37041,3,38351,5,1310,2001,2004,,
323,38351,5,38716,5,365,2004,2005,,
324,38137,3,38716,3,579,2004,2005,,
325,36463,6,36667,6,204,1999,2000,,
325,36667,6,36676,6,9,2000,2000,,
325,36676,6,37032,7,356,2000,2001,,
325,37032,7,37072,7,40,2001,2001,,
326,38189,3,38716,3,527,2004,2005,,
328,36310,6,36667,5,357,1999,2000,,
328,36667,5,38220,5,1553,2000,2004,,
328,38220,5,38716,5,496,2004,2005,,
329,37225,4,37255,5,30,2001,2001,,
329,37255,5,38716,6,1461,2001,2005,,
329,37255,6,37428,6,173,2001,2002,,
329,37428,6,37924,7,496,2002,2003,,
329,37924,7,38716,7,792,2003,2005,,
330,37793,6,38716,6,923,2003,2005,,
331,36494,6,36890,7,396,1999,2000,,
331,36890,7,38716,7,1826,2000,2005,,
334,36310,6,36332,8,22,1999,1999,,
334,36332,8,36494,5,162,1999,1999,,
334,36494,5,37037,5,543,1999,2001,,
334,37037,5,38716,5,1679,2001,2005,,
335,37133,4,37985,3,852,2001,2003,,
335,37985,3,38716,3,731,2003,2005,,
336,37771,4,38716,4,945,2003,2005,,
337,37590,4,38716,4,1126,2002,2005,,
338,36672,3,38281,3,1609,2000,2004,,
338,38281,3,38716,3,435,2004,2005,,
339,36371,3,36494,4,123,1999,1999,,
339,36494,4,37032,4,538,1999,2001,,
339,37032,4,37255,4,223,2001,2001,,
339,37255,4,38625,4,1370,2001,2005,,
339,38625,4,38716,4,91,2005,2005,,
340,36310,5,37885,6,1575,1999,2003,,
340,37885,6,38716,6,831,2003,2005,,
341,38128,2,38716,2,588,2004,2005,,
342,36524,6,37032,6,508,1999,2001,,
342,37032,6,37124,7,92,2001,2001,,
342,37124,7,37155,8,31,2001,2001,,
342,37155,8,37225,7,70,2001,2001,,
342,37225,7,37255,6,30,2001,2001,,
342,37255,6,37985,7,730,2001,2003,,
342,37985,7,38716,7,731,2003,2005,,
343,37529,4,38251,3,722,2002,2004,,
343,38251,3,38716,3,465,2004,2005,,
344,37041,4,38716,4,1675,2001,2005,,
345,36310,5,36667,5,357,1999,2000,,
346,37255,4,37620,5,365,2001,2002,,
346,37620,5,38716,5,1096,2002,2005,,
347,38351,4,38716,4,365,2004,2005,,
348,36301,3,38168,3,1867,1999,2004,,
348,38168,3,38716,3,548,2004,2005,,
350,36371,6,36454,5,83,1999,1999,,
350,36454,5,37255,6,801,1999,2001,,
350,37255,6,37771,6,516,2001,2003,,
350,37771,6,37985,6,214,2003,2003,,
351,36676,4,36890,6,214,2000,2000,,
351,36890,6,38716,8,1826,2000,2005,,
352,37041,4,37620,4,579,2001,2002,,
352,37620,4,38716,4,1096,2002,2005,,
354,36698,4,37225,4,527,2000,2001,,
354,37225,4,38168,5,943,2001,2004,,
354,38168,5,38716,5,548,2004,2005,,
355,36524,6,37129,8,605,1999,2001,,
355,37129,8,38716,8,1587,2001,2005,,
356,37397,3,37985,4,588,2002,2003,,
356,37985,4,38351,4,366,2003,2004,,
356,38351,4,38716,4,365,2004,2005,,
357,36768,2,36890,3,122,2000,2000,,
357,36890,3,37185,2,295,2000,2001,,
357,37185,2,38716,2,1531,2001,2005,,
358,36524,4,37032,4,508,1999,2001,,
358,37529,4,38716,4,1187,2002,2005,,
360,37255,2,38716,2,1461,2001,2005,,
361,37832,4,38716,4,884,2003,2005,,
362,36728,3,38716,3,1988,2000,2005,,
364,37041,3,37832,4,791,2001,2003,,
364,37832,4,38716,4,884,2003,2005,,
365,37581,2,38716,2,1135,2002,2005,,
369,37406,1,38716,1,1310,2002,2005,,
371,36890,1,38716,1,1826,2000,2005,,
372,36341,3,36728,3,387,1999,2000,,
372,36728,3,36820,2,92,2000,2000,,
372,36820,2,37041,2,221,2000,2001,,
373,36301,3,36676,2,375,1999,2000,,
373,36676,2,36890,3,214,2000,2000,,
373,36890,3,37093,2,203,2000,2001,,
373,37093,2,38716,2,1623,2001,2005,,
374,36890,2,38716,2,1826,2000,2005,,
375,38321,2,38716,2,395,2004,2005,,
376,36424,3,37032,4,608,1999,2001,,
376,37032,4,37397,4,365,2001,2002,,
376,37397,4,37985,5,588,2002,2003,,
376,37985,5,38716,5,731,2003,2005,,
377,37762,4,38716,4,954,2003,2005,,
378,37985,4,38716,4,731,2003,2005,,
379,37952,2,38716,2,764,2003,2005,,
380,36701,3,38716,3,2015,2000,2005,,
382,36676,3,37164,2,488,2000,2001,,
382,37164,2,38716,2,1552,2001,2005,,
385,38502,5,38716,5,214,2005,2005,,
386,36524,6,37185,6,661,1999,2001,,
386,37185,6,37762,6,577,2001,2003,,
386,37762,6,38351,6,589,2003,2004,,
386,38351,6,38533,7,182,2004,2005,,
386,38533,7,38716,7,183,2005,2005,,
387,36524,3,38716,3,2192,1999,2005,,
388,37458,3,38716,3,1258,2002,2005,,
389,36310,3,37406,3,1096,1999,2002,,
389,37406,3,38716,3,1310,2002,2005,,
390,36301,2,37551,3,1250,1999,2002,,
390,37551,3,37985,2,434,2002,2003,,
390,37985,2,38716,2,731,2003,2005,,
391,36790,3,37620,2,830,2000,2002,,
392,36890,3,38716,3,1826,2000,2005,,
393,36890,6,37255,5,365,2000,2001,,
393,37255,5,37620,5,365,2001,2002,,
393,37620,5,38251,5,631,2002,2004,,
393,38251,5,38716,5,465,2004,2005,,
394,38189,6,38220,5,31,2004,2004,,
394,38220,5,38716,5,496,2004,2005,,
396,36890,4,37255,3,365,2000,2001,,
396,37255,3,38499,3,1244,2001,2005,,
396,38499,3,38716,3,217,2005,2005,,
397,37397,3,38716,3,1319,2002,2005,,
398,37063,2,38716,2,1653,2001,2005,,
401,36301,4,38128,3,1827,1999,2004,,
401,38128,3,38251,3,123,2004,2004,,
401,38251,3,38716,3,465,2004,2005,,
403,36463,4,38128,4,1665,1999,2004,,
403,38128,4,38502,3,374,2004,2005,,
403,38502,3,38716,3,214,2005,2005,,
404,36667,2,38716,2,2049,2000,2005,,
405,36676,2,38716,2,2040,2000,2005,,
406,36310,7,38716,8,2406,1999,2005,,
409,37620,3,38351,2,731,2002,2004,,
409,38351,2,38716,2,365,2004,2005,,
411,36301,6,36524,6,223,1999,1999,,
411,36524,6,37255,6,731,1999,2001,,
412,36304,5,36768,4,464,1999,2000,,
412,36768,4,37590,4,822,2000,2002,,
413,36310,3,36890,2,580,1999,2000,,
413,36890,2,38716,2,1826,2000,2005,,
414,37762,2,38229,2,467,2003,2004,,
414,38229,2,38716,2,487,2004,2005,,
415,36371,2,38716,2,2345,1999,2005,,
416,37032,3,38716,3,1684,2001,2005,,
417,36799,3,38716,3,1917,2000,2005,,
418,37255,2,38716,2,1461,2001,2005,,
419,37255,2,38716,2,1461,2001,2005,,
421,36890,4,37498,5,608,2000,2002,,
421,37498,5,38716,5,1218,2002,2005,,
422,36332,5,36676,4,344,1999,2000,,
422,36676,4,37093,4,417,2000,2001,,
422,37093,4,37404,4,311,2001,2002,,
422,37404,4,38716,4,1312,2002,2005,,
423,38351,4,38716,4,365,2004,2005,,
424,36887,2,37762,3,875,2000,2003,,
424,37762,3,38716,3,954,2003,2005,,
425,36676,2,37620,3,944,2000,2002,,
425,37620,3,37771,3,151,2002,2003,,
425,37771,3,38716,3,945,2003,2005,,
426,37255,3,37985,3,730,2001,2003,,
426,37985,3,38716,3,731,2003,2005,,
427,36829,3,38716,3,1887,2000,2005,,
428,37194,3,38716,3,1522,2001,2005,,
429,37437,4,38716,4,1279,2002,2005,,
430,36829,2,37428,3,599,2000,2002,,
430,37428,3,37762,3,334,2002,2003,,
430,37762,3,38716,3,954,2003,2005,,
431,36860,2,37406,3,546,2000,2002,,
431,37406,3,37832,3,426,2002,2003,,
431,37832,3,38716,3,884,2003,2005,,
432,37164,3,38716,3,1552,2001,2005,,
433,36460,5,36890,6,430,1999,2000,,
433,36890,6,37255,5,365,2000,2001,,
433,37255,5,37462,5,207,2001,2002,,
434,37985,3,38716,3,731,2003,2005,,
435,37032,2,37255,3,223,2001,2001,,
435,37255,3,37397,4,142,2001,2002,,
435,37397,4,37398,5,1,2002,2002,,
435,37398,5,37467,3,69,2002,2002,,
435,37467,3,37620,4,153,2002,2002,,
435,37620,4,38716,6,1096,2002,2005,,
435,37620,6,38351,5,731,2002,2004,,
435,38351,5,38716,5,365,2004,2005,,
436,37255,4,38716,4,1461,2001,2005,,
438,36310,3,38716,3,2406,1999,2005,,
439,36310,4,37620,5,1310,1999,2002,,
439,37620,5,37863,5,243,2002,2003,,
439,37863,5,38128,6,265,2003,2004,,
442,37550,3,38716,3,1166,2002,2005,,
443,36302,3,36667,3,365,1999,2000,,
443,36667,3,38716,3,2049,2000,2005,,
443,36890,3,38716,3,1826,2000,2005,,
444,36768,2,37762,3,994,2000,2003,,
444,37762,3,38351,3,589,2003,2004,,
444,38351,3,38716,3,365,2004,2005,,
445,36424,4,38716,4,2292,1999,2005,,
446,36676,2,37985,3,1309,2000,2003,,
446,37985,3,38137,3,152,2003,2004,,
446,38137,3,38716,3,579,2004,2005,,
447,37437,2,38716,2,1279,2002,2005,,
448,38498,4,38716,4,218,2005,2005,,
449,37762,3,38716,3,954,2003,2005,,
450,36341,5,36524,4,183,1999,1999,,
450,36524,4,36768,5,244,1999,2000,,
450,36768,5,38716,5,1948,2000,2005,,
450,36768,5,37397,5,629,2000,2002,,
451,36393,5,38716,5,2323,1999,2005,,
452,36890,6,37038,7,148,2000,2001,,
452,37038,7,37185,7,147,2001,2001,,
452,37185,7,37255,8,70,2001,2001,,
453,36676,6,38716,6,2040,2000,2005,,
454,36393,6,37793,5,1400,1999,2003,,
454,37793,5,38716,5,923,2003,2005,,
455,37620,4,38716,4,1096,2002,2005,,
456,38290,6,38716,6,426,2004,2005,,
457,36307,6,37093,7,786,1999,2001,,
457,37093,7,38351,6,1258,2001,2004,,
457,38351,6,38716,6,365,2004,2005,,
458,37985,5,38168,4,183,2003,2004,,
458,38168,4,38716,4,548,2004,2005,,
459,37155,3,37976,3,821,2001,2003,,
459,37976,3,38716,3,740,2003,2005,,
460,37762,6,38716,6,954,2003,2005,,
462,36402,3,38128,3,1726,1999,2004,,
462,38128,3,38716,3,588,2004,2005,,
464,37863,2,38716,2,853,2003,2005,,
465,37032,5,37397,6,365,2001,2002,,
465,37397,6,37520,6,123,2002,2002,,
465,37520,6,38716,6,1196,2002,2005,,
467,37620,4,38716,3,1096,2002,2005,,
467,37620,3,38716,3,1096,2002,2005,,
468,36890,5,38716,5,1826,2000,2005,,
469,36671,3,37620,3,949,2000,2002,,
469,37620,3,38716,3,1096,2002,2005,,
470,36393,3,36524,3,131,1999,1999,,
470,36524,3,38716,3,2192,1999,2005,,
471,36676,4,37620,5,944,2000,2002,,
471,37620,5,38128,5,508,2002,2004,,
471,38128,5,38189,5,61,2004,2004,,
471,38189,5,38716,5,527,2004,2005,,
472,37041,2,38686,2,1645,2001,2005,,
472,38686,2,38716,2,30,2005,2005,,
473,36402,4,37131,4,729,1999,2001,,
473,37131,4,37762,4,631,2001,2003,,
473,37762,4,38716,4,954,2003,2005,,
474,36676,6,37559,6,883,2000,2002,,
474,37559,6,38251,6,692,2002,2004,,
474,38251,6,38716,6,465,2004,2005,,
475,38220,2,38716,2,496,2004,2005,,
476,36860,4,37185,4,325,2000,2001,,
476,37185,4,38351,3,1166,2001,2004,,
476,38351,3,38716,3,365,2004,2005,,
477,37406,2,37762,3,356,2002,2003,,
477,37762,3,38716,3,954,2003,2005,,
478,38128,2,38716,2,588,2004,2005,,
479,36335,3,37762,4,1427,1999,2003,,
479,37762,4,38351,4,589,2003,2004,,
479,38351,4,38716,4,365,2004,2005,,
480,36362,3,37762,4,1400,1999,2003,,
480,37762,4,38351,4,589,2003,2004,,
480,38351,4,38716,4,365,2004,2005,,
481,36707,3,37185,4,478,2000,2001,,
481,37185,4,37406,5,221,2001,2002,,
481,37406,5,38716,5,1310,2002,2005,,
482,36304,2,38716,2,2412,1999,2005,,
483,36667,3,38716,3,2049,2000,2005,,
484,37620,3,37771,4,151,2002,2003,,
484,37771,4,38716,4,945,2003,2005,,
487,36790,3,37036,4,246,2000,2001,,
487,37036,4,38716,4,1680,2001,2005,,
488,36890,3,38716,3,1826,2000,2005,,
489,37618,3,37620,3,2,2002,2002,,
489,37620,3,38285,3,665,2002,2004,,
489,38285,3,38716,3,431,2004,2005,,
491,38129,3,38716,3,587,2004,2005,,
493,37802,3,38716,3,914,2003,2005,,
495,36301,5,36310,6,9,1999,1999,,
495,36310,6,38167,6,1857,1999,2004,,
495,38167,6,38716,6,549,2004,2005,,
496,37559,4,38716,4,1157,2002,2005,,
497,36890,2,38716,2,1826,2000,2005,,
498,38189,6,38716,6,527,2004,2005,,
499,36524,8,38716,8,2192,1999,2005,,
500,37762,5,38137,5,375,2003,2004,,
500,38137,5,38716,5,579,2004,2005,,
501,36524,5,36667,5,143,1999,2000,,
501,36667,5,36676,6,9,2000,2000,,
501,36676,6,37041,7,365,2000,2001,,
503,36301,3,37985,2,1684,1999,2003,,
503,37985,2,38716,2,731,2003,2005,,
504,36393,5,36668,4,275,1999,2000,,
504,36668,4,37216,5,548,2000,2001,,
504,37216,5,37793,6,577,2001,2003,,
504,37793,6,38716,6,923,2003,2005,,
507,36424,3,37255,3,831,1999,2001,,
507,37255,3,38716,3,1461,2001,2005,,
509,37620,4,37771,4,151,2002,2003,,
509,37771,4,37985,4,214,2003,2003,,
509,37985,4,38716,4,731,2003,2005,,
510,36860,3,38716,3,1856,2000,2005,,
511,37762,4,38716,4,954,2003,2005,,
512,37520,4,38716,4,1196,2002,2005,,
513,36667,4,37985,4,1318,2000,2003,,
513,37985,4,38716,4,731,2003,2005,,
514,37762,2,38716,2,954,2003,2005,,
516,37041,2,38716,2,1675,2001,2005,,
517,36310,4,38716,4,2406,1999,2005,,
520,37620,3,38128,3,508,2002,2004,,
520,38128,3,38716,3,588,2004,2005,,
521,37041,3,38716,3,1675,2001,2005,,
522,36676,3,37985,4,1309,2000,2003,,
522,37985,4,38716,4,731,2003,2005,,
523,36301,5,37032,4,731,1999,2001,,
524,36667,2,37406,1,739,2000,2002,,
524,37406,1,38716,1,1310,2002,2005,,
525,37924,4,38716,4,792,2003,2005,,
526,37550,3,38351,3,801,2002,2004,,
526,38351,3,38716,3,365,2004,2005,,
527,38162,3,38351,4,189,2004,2004,,
527,38351,4,38716,4,365,2004,2005,,
528,36674,5,36890,4,216,2000,2000,,
529,38351,3,38716,3,365,2004,2005,,
530,36332,6,36371,5,39,1999,1999,,
530,36371,5,36676,7,305,1999,2000,,
530,36676,7,36759,8,83,2000,2000,,
530,37762,7,38260,6,498,2003,2004,,
530,38260,6,38716,6,456,2004,2005,,
531,37985,2,38312,2,327,2003,2004,,
531,38312,2,38716,2,404,2004,2005,,
532,37620,3,38716,3,1096,2002,2005,,
533,36890,4,38716,4,1826,2000,2005,,
534,37559,3,38716,3,1157,2002,2005,,
535,36890,4,37406,4,516,2000,2002,,
535,37406,4,38716,4,1310,2002,2005,,
536,36301,3,37032,2,731,1999,2001,,
536,37032,2,38128,2,1096,2001,2004,,
536,38128,2,38716,2,588,2004,2005,,
538,36332,4,36737,4,405,1999,2000,,
538,36737,4,37133,4,396,2000,2001,,
538,37133,4,38189,4,1056,2001,2004,,
538,38189,4,38716,4,527,2004,2005,,
539,37397,4,38351,4,954,2002,2004,,
539,38351,4,38716,4,365,2004,2005,,
540,37985,3,38137,3,152,2003,2004,,
540,38137,3,38716,3,579,2004,2005,,
541,37255,5,37762,6,507,2001,2003,,
541,37762,6,38716,6,954,2003,2005,,
542,37041,3,37620,3,579,2001,2002,,
542,37620,3,38716,3,1096,2002,2005,,
543,36433,5,38716,5,2283,1999,2005,,
545,37590,3,38716,3,1126,2002,2005,,
546,37102,4,38351,4,1249,2001,2004,,
546,38351,4,38716,4,365,2004,2005,,
547,37041,6,37255,6,214,2001,2001,,
547,37955,8,38716,8,761,2003,2005,,
548,36890,3,38716,3,1826,2000,2005,,
549,37955,3,38716,3,761,2003,2005,,
551,37428,3,37985,2,557,2002,2003,,
551,37985,2,38716,2,731,2003,2005,,
552,37406,4,37467,3,61,2002,2002,,
552,37467,3,38716,3,1249,2002,2005,,
553,36667,6,37403,8,736,2000,2002,,
553,37529,7,37620,6,91,2002,2002,,
553,37620,6,38716,6,1096,2002,2005,,
554,36728,4,38716,4,1988,2000,2005,,
555,37032,5,37255,6,223,2001,2001,,
555,37255,6,37985,7,730,2001,2003,,
555,37985,7,38716,7,731,2003,2005,,
556,37255,5,38502,6,1247,2001,2005,,
556,38502,6,38716,6,214,2005,2005,,
557,37157,3,37985,3,828,2001,2003,,
557,37985,3,38716,3,731,2003,2005,,
558,36524,6,37397,6,873,1999,2002,,
558,37397,6,38716,6,1319,2002,2005,,
559,36463,6,36524,6,61,1999,1999,,
559,36524,6,37032,6,508,1999,2001,,
559,37032,6,37489,7,457,2001,2002,,
559,37489,7,37620,6,131,2002,2002,,
559,37620,6,37762,7,142,2002,2003,,
559,37762,7,37915,6,153,2003,2003,,
560,37489,3,38128,2,639,2002,2004,,
560,38128,2,38716,2,588,2004,2005,,
561,37489,2,38351,2,862,2002,2004,,
561,38351,2,38716,2,365,2004,2005,,
562,37458,3,38351,2,893,2002,2004,,
562,38351,2,38716,2,365,2004,2005,,
564,36463,4,36768,3,305,1999,2000,,
564,36768,3,38220,3,1452,2000,2004,,
564,38220,3,38716,3,496,2004,2005,,
566,37620,2,38716,2,1096,2002,2005,,
567,37611,2,38716,2,1105,2002,2005,,
568,37620,2,38716,2,1096,2002,2005,,
569,37590,3,38716,3,1126,2002,2005,,
570,37620,2,38716,2,1096,2002,2005,,
571,36310,5,36890,5,580,1999,2000,,
571,36890,5,37185,6,295,2000,2001,,
571,37185,6,38716,6,1531,2001,2005,,
572,38351,4,38716,4,365,2004,2005,,
574,37771,3,38716,3,945,2003,2005,,
575,37133,3,37255,2,122,2001,2001,,
575,37255,2,38716,2,1461,2001,2005,,
576,36308,4,38716,4,2408,1999,2005,,
577,36301,3,36890,3,589,1999,2000,,
577,36890,3,37032,3,142,2000,2001,,
577,37032,3,38716,3,1684,2001,2005,,
578,36301,3,36881,3,580,1999,2000,,
578,36881,3,37032,3,151,2000,2001,,
578,37032,3,38716,3,1684,2001,2005,,
579,36667,2,37581,3,914,2000,2002,,
580,36676,2,37581,3,905,2000,2002,,
580,37581,3,38716,3,1135,2002,2005,,
581,37095,6,38128,5,1033,2001,2004,,
581,38128,5,38342,5,214,2004,2004,,
581,38342,5,38716,5,374,2004,2005,,
582,37885,3,38716,3,831,2003,2005,,
583,36524,5,37832,6,1308,1999,2003,,
583,37832,6,38563,6,731,2003,2005,,
583,38563,6,38716,6,153,2005,2005,,
584,37802,4,38716,4,914,2003,2005,,
585,36303,4,37255,4,952,1999,2001,,
585,37255,4,37985,4,730,2001,2003,,
585,37985,4,38502,5,517,2003,2005,,
585,38502,5,38716,5,214,2005,2005,,
586,37032,4,37398,5,366,2001,2002,,
586,37398,5,38716,5,1318,2002,2005,,
587,37467,5,37924,5,457,2002,2003,,
587,37924,5,38716,5,792,2003,2005,,
588,37032,6,37552,6,520,2001,2002,,
588,37552,6,37793,7,241,2002,2003,,
588,37793,7,38128,7,335,2003,2004,,
588,38128,7,38716,7,588,2004,2005,,
589,36890,5,38716,5,1826,2000,2005,,
590,37762,5,38351,5,589,2003,2004,,
590,38351,5,38716,5,365,2004,2005,,
591,37071,2,38716,2,1645,2001,2005,,
592,36310,4,37255,4,945,1999,2001,,
593,36524,4,37406,4,882,1999,2002,,
593,37406,4,37550,7,144,2002,2002,,
593,37550,7,37590,5,40,2002,2002,,
593,37590,5,37985,5,395,2002,2003,,
593,37985,5,38716,5,731,2003,2005,,
594,36674,3,38716,3,2042,2000,2005,,
595,36759,4,38128,5,1369,2000,2004,,
595,38128,5,38351,4,223,2004,2004,,
595,38351,4,38716,4,365,2004,2005,,
596,36524,7,36790,6,266,1999,2000,,
596,36790,6,37823,6,1033,2000,2003,,
596,37823,6,38716,6,893,2003,2005,,
598,37041,7,37255,8,214,2001,2001,,
598,37255,8,38716,8,1461,2001,2005,,
599,37764,3,38716,3,952,2003,2005,,
600,37770,3,38716,3,946,2003,2005,,
601,37620,4,38493,4,873,2002,2005,,
601,38493,4,38716,4,223,2005,2005,,
602,36676,5,37124,4,448,2000,2001,,
602,37124,4,38716,4,1592,2001,2005,,
603,38351,3,38716,3,365,2004,2005,,
604,36310,4,37467,4,1157,1999,2002,,
604,37467,4,37620,4,153,2002,2002,,
604,37620,4,38716,5,1096,2002,2005,,
604,37620,5,37771,7,151,2002,2003,,
604,37771,7,38716,7,945,2003,2005,,
605,36310,4,38716,4,2406,1999,2005,,
606,36524,6,36667,7,143,1999,2000,,
606,36667,7,37124,7,457,2000,2001,,
607,37155,4,38716,4,1561,2001,2005,,
608,37032,2,38716,2,1684,2001,2005,,
609,37216,4,38716,4,1500,2001,2005,,
610,36524,5,38716,5,2192,1999,2005,,
611,36310,4,37406,4,1096,1999,2002,,
611,37406,4,37520,5,114,2002,2002,,
611,37520,5,37955,6,435,2002,2003,,
611,37955,6,38716,6,761,2003,2005,,
612,36332,4,36768,3,436,1999,2000,,
613,37437,4,38716,4,1279,2002,2005,,
614,37038,3,38716,3,1678,2001,2005,,
615,37406,4,38716,4,1310,2002,2005,,
615,37406,4,38716,4,1310,2002,2005,,
616,36820,4,37032,7,212,2000,2001,,
616,37032,7,37041,6,9,2001,2001,,
616,37041,6,37255,5,214,2001,2001,,
617,36524,4,38655,4,2131,1999,2005,,
617,38655,4,38716,4,61,2005,2005,,
618,36728,4,37194,3,466,2000,2001,,
618,37194,3,38716,3,1522,2001,2005,,
619,37255,3,38716,3,1461,2001,2005,,
620,37155,2,38716,2,1561,2001,2005,,
621,36301,5,36860,6,559,1999,2000,,
621,36860,6,37164,5,304,2000,2001,,
621,37164,5,38716,5,1552,2001,2005,,
622,37498,4,37985,4,487,2002,2003,,
622,37985,4,38716,4,731,2003,2005,,
623,37255,3,37620,3,365,2001,2002,,
623,37620,3,38716,3,1096,2002,2005,,
624,37124,3,37620,3,496,2001,2002,,
624,37620,3,38716,3,1096,2002,2005,,
625,37063,3,37620,3,557,2001,2002,,
625,37620,3,38716,3,1096,2002,2005,,
626,36310,3,36667,2,357,1999,2000,,
626,36667,2,37397,2,730,2000,2002,,
626,37397,2,38716,2,1319,2002,2005,,
627,36698,3,38716,3,2018,2000,2005,,
628,36668,5,36890,4,222,2000,2000,,
628,36890,4,38159,5,1269,2000,2004,,
628,38159,5,38716,5,557,2004,2005,,
629,37985,3,38716,3,731,2003,2005,,
630,36424,3,36829,2,405,1999,2000,,
631,36362,4,36676,4,314,1999,2000,,
631,36676,4,37185,4,509,2000,2001,,
631,37185,4,38716,4,1531,2001,2005,,
632,37590,4,37985,4,395,2002,2003,,
632,37985,4,38351,5,366,2003,2004,,
632,38351,5,38716,5,365,2004,2005,,
633,36306,3,38290,3,1984,1999,2004,,
633,38290,3,38716,3,426,2004,2005,,
634,36676,4,37620,3,944,2000,2002,,
634,37620,3,38716,3,1096,2002,2005,,
635,36524,6,36707,7,183,1999,2000,,
636,37032,4,37063,5,31,2001,2001,,
636,37063,5,37255,6,192,2001,2001,,
636,37255,6,37402,6,147,2001,2002,,
636,37402,6,37763,7,361,2002,2003,,
636,37763,7,38716,7,953,2003,2005,,
637,36524,5,37032,4,508,1999,2001,,
637,37032,4,37072,3,40,2001,2001,,
637,37072,3,38493,4,1421,2001,2005,,
637,38493,4,38716,4,223,2005,2005,,
638,37125,2,38351,2,1226,2001,2004,,
638,38351,2,38716,2,365,2004,2005,,
639,36433,6,36676,5,243,1999,2000,,
640,37032,4,37458,3,426,2001,2002,,
640,37458,3,38716,3,1258,2002,2005,,
641,36524,4,36860,5,336,1999,2000,,
641,36860,5,36890,6,30,2000,2000,,
641,36890,6,37406,7,516,2000,2002,,
641,37406,7,37467,6,61,2002,2002,,
641,37467,6,37590,7,123,2002,2002,,
641,37590,7,37620,8,30,2002,2002,,
642,38260,1,38716,1,456,2004,2005,,
643,37093,3,38716,3,1623,2001,2005,,
644,36524,4,38716,4,2192,1999,2005,,
645,36310,6,37032,7,722,1999,2001,,
645,37032,7,37255,7,223,2001,2001,,
646,36310,3,38351,3,2041,1999,2004,,
646,38351,3,38716,3,365,2004,2005,,
647,36860,4,37529,4,669,2000,2002,,
647,37529,4,38716,4,1187,2002,2005,,
648,37041,3,38716,3,1675,2001,2005,,
649,37063,6,37255,6,192,2001,2001,,
649,37255,6,37399,6,144,2001,2002,,
649,37399,6,37924,7,525,2002,2003,,
649,37924,7,38716,7,792,2003,2005,,
650,36310,4,36759,3,449,1999,2000,,
650,36759,3,37155,4,396,2000,2001,,
650,37155,4,37255,4,100,2001,2001,,
650,37255,4,37489,4,234,2001,2002,,
650,37489,4,38493,4,1004,2002,2005,,
650,38493,4,38716,4,223,2005,2005,,
651,36667,4,37255,4,588,2000,2001,,
651,37255,4,38716,4,1461,2001,2005,,
653,37155,4,38716,4,1561,2001,2005,,
653,38716,4,38716,4,0,2005,2005,,
655,37246,2,38716,2,1470,2001,2005,,
656,37127,2,37255,1,128,2001,2001,,
656,37255,1,38128,2,873,2001,2004,,
656,38128,2,38716,2,588,2004,2005,,
657,37218,2,37255,2,37,2001,2001,,
657,37255,2,38716,2,1461,2001,2005,,
658,36890,1,38716,1,1826,2000,2005,,
659,37620,3,38716,3,1096,2002,2005,,
660,36454,3,36524,3,70,1999,1999,,
660,36524,3,37255,4,731,1999,2001,,
660,37255,4,38502,4,1247,2001,2005,,
660,38502,4,38716,4,214,2005,2005,,
662,38189,6,38716,6,527,2004,2005,,
663,36667,3,37155,4,488,2000,2001,,
663,37155,4,37255,3,100,2001,2001,,
663,37255,3,37406,4,151,2001,2002,,
663,37406,4,37428,5,22,2002,2002,,
663,37428,5,38716,5,1288,2002,2005,,
664,37102,3,38716,3,1614,2001,2005,,
665,38220,4,38716,4,496,2004,2005,,
667,37102,6,38716,6,1614,2001,2005,,
668,36890,3,37133,3,243,2000,2001,,
668,37133,3,38260,2,1127,2001,2004,,
668,38260,2,38716,2,456,2004,2005,,
669,36860,3,37032,3,172,2000,2001,,
670,37034,2,37041,2,7,2001,2001,,
670,37041,2,38716,2,1675,2001,2005,,
671,37160,2,38716,2,1556,2001,2005,,
673,36890,2,37491,2,601,2000,2002,,
673,37491,2,38716,2,1225,2002,2005,,
674,37402,7,37770,7,368,2002,2003,,
674,37770,7,38137,8,367,2003,2004,,
675,36698,4,37032,7,334,2000,2001,,
675,37032,7,37155,8,123,2001,2001,,
675,37155,8,37766,6,611,2001,2003,,
675,37766,6,38716,6,950,2003,2005,,
676,37225,4,37406,5,181,2001,2002,,
676,37406,5,37620,5,214,2002,2002,,
676,37620,5,38716,5,1096,2002,2005,,
678,37620,3,38716,3,1096,2002,2005,,
680,36301,4,36667,3,366,1999,2000,,
680,36667,3,38168,3,1501,2000,2004,,
680,38168,3,38258,3,90,2004,2004,,
680,38258,3,38716,3,458,2004,2005,,
681,36676,6,37037,7,361,2000,2001,,
682,36301,4,36707,3,406,1999,2000,,
682,36707,3,38351,3,1644,2000,2004,,
682,38351,3,38716,3,365,2004,2005,,
683,36301,4,36667,3,366,1999,2000,,
683,36667,3,38168,3,1501,2000,2004,,
683,38168,3,38716,3,548,2004,2005,,
684,37032,3,38716,3,1684,2001,2005,,
685,36524,6,37255,7,731,1999,2001,,
685,37255,7,37832,6,577,2001,2003,,
685,37832,6,37985,8,153,2003,2003,,
686,36790,4,37194,4,404,2000,2001,,
686,37194,4,37255,5,61,2001,2001,,
686,37255,5,37467,5,212,2001,2002,,
686,37467,5,38716,5,1249,2002,2005,,
687,37032,5,37133,4,101,2001,2001,,
687,37133,4,37467,5,334,2001,2002,,
687,37467,5,38351,5,884,2002,2004,,
687,38351,5,38716,5,365,2004,2005,,
688,37766,3,38189,3,423,2003,2004,,
688,38189,3,38716,3,527,2004,2005,,
691,36799,3,37762,4,963,2000,2003,,
691,37762,4,38351,5,589,2003,2004,,
691,38351,5,38716,5,365,2004,2005,,
692,36759,3,37032,4,273,2000,2001,,
692,37032,4,37498,6,466,2001,2002,,
692,37498,6,37762,5,264,2002,2003,,
692,37762,5,37955,5,193,2003,2003,,
692,37955,5,38716,5,761,2003,2005,,
693,38351,4,38716,4,365,2004,2005,,
694,37041,4,38716,4,1675,2001,2005,,
695,37397,3,38716,3,1319,2002,2005,,
696,36759,3,38533,4,1774,2000,2005,,
696,38533,4,38716,4,183,2005,2005,,
697,36310,2,38716,2,2406,1999,2005,,
698,37885,4,38716,4,831,2003,2005,,
700,36301,6,37771,5,1470,1999,2003,,
700,37771,5,38563,6,792,2003,2005,,
700,38563,6,38716,6,153,2005,2005,,
701,37063,5,37255,5,192,2001,2001,,
701,37255,5,37762,6,507,2001,2003,,
701,37762,6,38137,7,375,2003,2004,,
701,38137,7,38351,7,214,2004,2004,,
701,38351,7,38716,8,365,2004,2005,,
701,38351,8,38716,8,365,2004,2005,,
703,37406,3,38135,4,729,2002,2004,,
703,38135,4,38716,4,581,2004,2005,,
704,37032,2,38128,2,1096,2001,2004,,
704,38128,2,38716,2,588,2004,2005,,
705,36524,3,36667,3,143,1999,2000,,
705,36667,3,36790,3,123,2000,2000,,
705,36790,3,37559,2,769,2000,2002,,
705,37559,2,38716,2,1157,2002,2005,,
706,36301,1,38716,1,2415,1999,2005,,
707,38594,5,38716,5,122,2005,2005,,
708,36301,2,38716,2,2415,1999,2005,,
709,36301,2,38716,2,2415,1999,2005,,
710,37522,3,37529,2,7,2002,2002,,
710,37529,2,38716,2,1187,2002,2005,,
711,36860,4,37397,4,537,2000,2002,,
711,37397,4,38716,4,1319,2002,2005,,
712,36890,5,37063,5,173,2000,2001,,
712,37063,5,38351,4,1288,2001,2004,,
712,38351,4,38716,4,365,2004,2005,,
713,36301,4,36790,5,489,1999,2000,,
714,37765,6,38716,6,951,2003,2005,,
715,36860,2,37762,2,902,2000,2003,,
715,37762,2,38716,2,954,2003,2005,,
716,36524,6,37041,5,517,1999,2001,,
716,37041,5,37255,6,214,2001,2001,,
716,37255,6,37498,6,243,2001,2002,,
716,37498,6,38716,6,1218,2002,2005,,
717,36890,3,37041,4,151,2000,2001,,
717,37041,4,38716,4,1675,2001,2005,,
718,37771,4,38716,4,945,2003,2005,,
719,37620,2,38716,2,1096,2002,2005,,
720,36829,5,38137,4,1308,2000,2004,,
720,38137,4,38563,3,426,2004,2005,,
720,38563,3,38716,3,153,2005,2005,,
721,36524,5,36790,6,266,1999,2000,,
721,36790,6,36890,5,100,2000,2000,,
721,36890,5,37124,5,234,2000,2001,,
721,37124,5,38251,6,1127,2001,2004,,
722,37885,6,37985,6,100,2003,2003,,
722,37985,6,38128,6,143,2003,2004,,
722,38128,6,38716,6,588,2004,2005,,
724,36890,4,37854,6,964,2000,2003,,
724,37854,6,38716,6,862,2003,2005,,
726,37985,4,38716,4,731,2003,2005,,
728,36524,6,38716,6,2192,1999,2005,,
729,36667,4,38716,4,2049,2000,2005,,
730,36890,3,37255,2,365,2000,2001,,
730,37255,2,38716,2,1461,2001,2005,,
732,38493,3,38716,3,223,2005,2005,,
733,36494,2,37032,2,538,1999,2001,,
733,37032,2,37406,2,374,2001,2002,,
733,37406,2,37985,3,579,2002,2003,,
733,37985,3,38716,3,731,2003,2005,,
734,37155,3,37255,3,100,2001,2001,,
734,37255,3,37498,4,243,2001,2002,,
735,36371,3,37762,4,1391,1999,2003,,
735,37762,4,37924,4,162,2003,2003,,
735,37924,4,38351,5,427,2003,2004,,
735,38351,5,38716,5,365,2004,2005,,
736,37771,4,38716,4,945,2003,2005,,
738,37461,5,37489,4,28,2002,2002,,
738,37489,4,38716,4,1227,2002,2005,,
739,37032,6,37768,6,736,2001,2003,,
739,37768,6,38502,7,734,2003,2005,,
739,38502,7,38594,7,92,2005,2005,,
739,38594,7,38716,7,122,2005,2005,,
741,36676,7,36890,6,214,2000,2000,,
741,36890,6,37620,6,730,2000,2002,,
741,37620,6,37762,7,142,2002,2003,,
742,37762,6,37985,6,223,2003,2003,,
742,37985,6,38716,6,731,2003,2005,,
743,37190,3,37467,4,277,2001,2002,,
743,37467,4,37985,4,518,2002,2003,,
743,37985,4,38495,5,510,2003,2005,,
743,38495,5,38716,5,221,2005,2005,,
745,36524,7,36698,7,174,1999,2000,,
747,36524,3,38716,3,2192,1999,2005,,
750,36433,5,36524,5,91,1999,1999,,
750,36524,5,36860,5,336,1999,2000,,
750,36860,5,38128,4,1268,2000,2004,,
750,38128,4,38716,4,588,2004,2005,,
751,36310,4,37520,4,1210,1999,2002,,
751,37520,4,38716,5,1196,2002,2005,,
751,37520,5,37894,6,374,2002,2003,,
751,37894,6,38716,6,822,2003,2005,,
752,37489,2,38716,2,1227,2002,2005,,
753,36667,4,38716,4,2049,2000,2005,,
754,36676,6,38716,6,2040,2000,2005,,
755,37620,7,38716,7,1096,2002,2005,,
756,37133,5,37397,4,264,2001,2002,,
756,37397,4,38281,4,884,2002,2004,,
756,38281,4,38716,4,435,2004,2005,,
759,36524,5,38716,5,2192,1999,2005,,
760,38137,3,38716,3,579,2004,2005,,
761,37397,3,38716,3,1319,2002,2005,,
763,37032,4,38716,4,1684,2001,2005,,
765,37406,3,37985,3,579,2002,2003,,
765,37985,3,38716,3,731,2003,2005,,
767,36524,2,38716,2,2192,1999,2005,,
769,37032,2,37985,3,953,2001,2003,,
770,37032,5,37620,6,588,2001,2002,,
770,37955,6,38716,6,761,2003,2005,,
771,36524,6,37924,6,1400,1999,2003,,
771,37924,6,37985,7,61,2003,2003,,
771,37985,7,38716,7,731,2003,2005,,
772,37216,8,37255,7,39,2001,2001,,
772,37985,6,38351,6,366,2003,2004,,
772,38351,6,38493,7,142,2004,2005,,
772,38493,7,38716,7,223,2005,2005,,
774,36890,2,38716,2,1826,2000,2005,,
776,37255,2,38716,2,1461,2001,2005,,
776,37255,2,37404,3,149,2001,2002,,
776,37404,3,38716,3,1312,2002,2005,,
777,37072,4,37397,5,325,2001,2002,,
777,37397,5,37620,5,223,2002,2002,,
777,37620,5,38716,5,1096,2002,2005,,
778,36494,5,38716,6,2222,1999,2005,,
778,36494,6,37194,6,700,1999,2001,,
778,37194,6,37985,6,791,2001,2003,,
778,37985,6,38716,6,731,2003,2005,,
779,37620,4,38716,4,1096,2002,2005,,
780,36667,2,37397,1,730,2000,2002,,
780,37397,1,38716,1,1319,2002,2005,,
781,36667,2,37397,1,730,2000,2002,,
781,37397,1,38716,1,1319,2002,2005,,
782,36667,5,36676,6,9,2000,2000,,
782,36676,6,36703,6,27,2000,2000,,
782,36703,6,37397,7,694,2000,2002,,
783,36728,6,36890,5,162,2000,2000,,
783,36890,5,37032,6,142,2000,2001,,
783,37032,6,38716,7,1684,2001,2005,,
783,37032,7,37071,7,39,2001,2001,,
784,36670,3,36829,4,159,2000,2000,,
784,36829,4,37063,4,234,2000,2001,,
784,37063,4,38716,4,1653,2001,2005,,
785,36454,4,38716,4,2262,1999,2005,,
786,37032,4,37194,4,162,2001,2001,,
786,37194,4,38716,5,1522,2001,2005,,
786,38716,5,38716,5,0,2005,2005,,
787,36301,3,37164,4,863,1999,2001,,
787,37164,4,37397,4,233,2001,2002,,
787,37397,4,37620,5,223,2002,2002,,
787,37620,5,37823,5,203,2002,2003,,
787,37823,5,38716,5,893,2003,2005,,
788,36301,3,36890,2,589,1999,2000,,
788,36890,2,37397,2,507,2000,2002,,
788,37397,2,38716,2,1319,2002,2005,,
789,37406,2,38716,2,1310,2002,2005,,
791,36310,3,36890,3,580,1999,2000,,
791,36890,3,37194,3,304,2000,2001,,
791,37194,3,38716,3,1522,2001,2005,,
793,36524,2,37255,2,731,1999,2001,,
793,37255,2,38716,2,1461,2001,2005,,
794,36524,3,38716,3,2192,1999,2005,,
795,37620,2,38625,2,1005,2002,2005,,
795,38625,2,38716,2,91,2005,2005,,
796,37620,2,38563,2,943,2002,2005,,
796,38563,2,38716,2,153,2005,2005,,
797,36494,7,36524,7,30,1999,1999,,
798,36667,2,38716,2,2049,2000,2005,,
799,36494,3,38189,3,1695,1999,2004,,
799,38189,3,38716,3,527,2004,2005,,
800,38128,4,38716,4,588,2004,2005,,
802,36402,3,38716,3,2314,1999,2005,,
805,37771,3,38716,3,945,2003,2005,,
806,37255,2,38128,2,873,2001,2004,,
806,38128,2,38716,2,588,2004,2005,,
807,36676,2,37620,2,944,2000,2002,,
807,37620,2,38493,2,873,2002,2005,,
807,38493,2,38716,2,223,2005,2005,,
809,37620,2,38655,2,1035,2002,2005,,
809,38655,2,38716,2,61,2005,2005,,
810,38128,2,38716,2,588,2004,2005,,
811,36676,3,37399,2,723,2000,2002,,
813,37490,2,38716,2,1226,2002,2005,,
815,36524,3,37762,2,1238,1999,2003,,
815,37762,2,38716,2,954,2003,2005,,
816,36890,2,37771,1,881,2000,2003,,
816,37771,1,38716,1,945,2003,2005,,
817,36676,3,38716,3,2040,2000,2005,,
818,37041,2,37255,2,214,2001,2001,,
819,37489,2,38716,2,1227,2002,2005,,
820,37581,2,38716,2,1135,2002,2005,,
821,36301,6,38716,6,2415,1999,2005,,
822,36759,3,37620,2,861,2000,2002,,
824,36676,3,37620,2,944,2000,2002,,
824,37620,2,38716,2,1096,2002,2005,,
825,36676,5,37185,6,509,2000,2001,,
825,37185,6,37194,6,9,2001,2001,,
825,37194,6,38716,6,1522,2001,2005,,
826,37032,5,37620,6,588,2001,2002,,
826,37955,7,38716,7,761,2003,2005,,
826,37955,7,38716,7,761,2003,2005,,
827,36820,3,38625,3,1805,2000,2005,,
827,38625,3,38716,3,91,2005,2005,,
828,37255,4,38716,4,1461,2001,2005,,
830,36759,4,37489,5,730,2000,2002,,
830,37489,5,37520,5,31,2002,2002,,
830,37520,5,37771,6,251,2002,2003,,
830,37771,6,38716,6,945,2003,2005,,
831,36667,3,37406,3,739,2000,2002,,
831,37406,3,38716,3,1310,2002,2005,,
832,36393,5,38716,5,2323,1999,2005,,
833,37397,4,37406,4,9,2002,2002,,
833,37406,4,37620,5,214,2002,2002,,
833,37620,5,37762,6,142,2002,2003,,
833,37762,6,37771,7,9,2003,2003,,
834,36667,3,37397,3,730,2000,2002,,
834,37397,3,38716,3,1319,2002,2005,,
835,36301,4,38716,4,2415,1999,2005,,
837,36336,4,36667,4,331,1999,2000,,
837,36667,4,38493,4,1826,2000,2005,,
837,38493,4,38716,4,223,2005,2005,,
838,36332,6,37032,5,700,1999,2001,,
838,37032,5,38716,5,1684,2001,2005,,
839,36332,3,37032,3,700,1999,2001,,
839,37032,3,37041,3,9,2001,2001,,
839,37041,3,37397,4,356,2001,2002,,
839,37397,4,37985,4,588,2002,2003,,
840,36310,4,36829,5,519,1999,2000,,
840,36829,5,36886,6,57,2000,2000,,
840,36886,6,36890,5,4,2000,2000,,
840,36890,5,37620,7,730,2000,2002,,
840,37620,7,38716,7,1096,2002,2005,,
841,37072,5,37255,5,183,2001,2001,,
841,37255,5,37520,6,265,2001,2002,,
841,37520,6,38493,5,973,2002,2005,,
841,38493,5,38716,5,223,2005,2005,,
842,38281,3,38716,3,435,2004,2005,,
843,37620,3,38351,2,731,2002,2004,,
843,38351,2,38716,2,365,2004,2005,,
844,37072,3,37771,4,699,2001,2003,,
844,37771,4,38351,4,580,2003,2004,,
844,38351,4,38716,4,365,2004,2005,,
845,37406,3,38716,3,1310,2002,2005,,
846,37406,4,38716,4,1310,2002,2005,,
847,36667,3,37620,4,953,2000,2002,,
848,36890,3,37620,3,730,2000,2002,,
849,36768,2,37406,3,638,2000,2002,,
849,37406,3,38716,3,1310,2002,2005,,
850,36829,2,37620,3,791,2000,2002,,
850,37620,3,38716,3,1096,2002,2005,,
851,36890,2,37620,3,730,2000,2002,,
851,37620,3,38281,3,661,2002,2004,,
851,38281,3,38716,3,435,2004,2005,,
852,37397,4,37620,4,223,2002,2002,,
852,37620,4,38716,4,1096,2002,2005,,
853,37041,3,38716,3,1675,2001,2005,,
854,37255,4,37397,5,142,2001,2002,,
854,37397,5,37406,5,9,2002,2002,,
854,37406,5,38137,5,731,2002,2004,,
854,38137,5,38251,5,114,2004,2004,,
854,38251,5,38502,4,251,2004,2005,,
854,38502,4,38716,4,214,2005,2005,,
856,36890,2,37620,2,730,2000,2002,,
856,37620,2,38716,2,1096,2002,2005,,
857,36524,5,38625,5,2101,1999,2005,,
857,38625,5,38716,5,91,2005,2005,,
858,37406,3,38716,3,1310,2002,2005,,
860,37225,4,37397,4,172,2001,2002,,
860,37397,4,38716,4,1319,2002,2005,,
863,36764,3,37762,3,998,2000,2003,,
863,37762,3,38716,3,954,2003,2005,,
864,36890,3,37620,4,730,2000,2002,,
864,37620,4,38716,4,1096,2002,2005,,
865,38312,4,38494,4,182,2004,2005,,
865,38494,4,38716,4,222,2005,2005,,
866,37762,3,38351,4,589,2003,2004,,
866,38351,4,38716,4,365,2004,2005,,
866,38716,4,38716,4,0,2005,2005,,
868,38198,4,38686,4,488,2004,2005,,
868,38686,4,38716,4,30,2005,2005,,
869,37762,3,38351,4,589,2003,2004,,
869,38351,4,38716,4,365,2004,2005,,
870,36890,4,37255,4,365,2000,2001,,
870,37255,4,38128,4,873,2001,2004,,
870,38128,4,38716,4,588,2004,2005,,
872,36890,2,37437,3,547,2000,2002,,
872,37437,3,38716,3,1279,2002,2005,,
873,36890,3,37620,3,730,2000,2002,,
873,37620,3,38716,3,1096,2002,2005,,
874,36676,2,37620,3,944,2000,2002,,
876,36890,2,37620,3,730,2000,2002,,
877,37924,4,38128,4,204,2003,2004,,
877,38128,4,38716,4,588,2004,2005,,
878,36698,2,37620,3,922,2000,2002,,
879,37194,3,38716,3,1522,2001,2005,,
880,36667,2,37620,3,953,2000,2002,,
881,38493,2,38716,2,223,2005,2005,,
882,36667,2,37520,3,853,2000,2002,,
883,36829,2,37620,3,791,2000,2002,,
885,36524,3,38716,3,2192,1999,2005,,
887,36524,5,37397,5,873,1999,2002,,
887,37397,5,38281,6,884,2002,2004,,
887,38281,6,38716,6,435,2004,2005,,
888,37397,2,37620,3,223,2002,2002,,
888,37620,3,37915,2,295,2002,2003,,
888,37915,2,38716,2,801,2003,2005,,
889,36515,5,37133,6,618,1999,2001,,
889,37133,6,38716,6,1583,2001,2005,,
891,36890,4,37406,5,516,2000,2002,,
891,37406,5,37762,5,356,2002,2003,,
891,37762,5,38716,5,954,2003,2005,,
893,36310,4,37620,5,1310,1999,2002,,
893,37620,5,38716,5,1096,2002,2005,,
895,37255,4,38716,4,1461,2001,2005,,
897,36301,4,36310,3,9,1999,1999,,
897,36310,3,36332,5,22,1999,1999,,
897,36332,5,36524,6,192,1999,1999,,
897,36524,6,36676,2,152,1999,2000,,
897,36676,2,38716,2,2040,2000,2005,,
898,37620,3,38716,3,1096,2002,2005,,
899,37771,5,37802,6,31,2003,2003,,
899,37802,6,37955,6,153,2003,2003,,
899,37955,6,38128,6,173,2003,2004,,
899,38128,6,38716,6,588,2004,2005,,
900,36524,2,37255,2,731,1999,2001,,
900,37255,2,38716,2,1461,2001,2005,,
902,37093,2,38716,2,1623,2001,2005,,
903,36890,3,37894,3,1004,2000,2003,,
903,37894,3,38716,3,822,2003,2005,,
906,36890,5,37102,6,212,2000,2001,,
906,37102,6,37558,6,456,2001,2002,,
906,37558,6,38351,7,793,2002,2004,,
906,38351,7,38716,7,365,2004,2005,,
907,36676,3,38493,3,1817,2000,2005,,
907,38493,3,38716,3,223,2005,2005,,
908,36332,3,37885,3,1553,1999,2003,,
908,37885,3,38716,3,831,2003,2005,,
911,36310,3,37620,3,1310,1999,2002,,
911,37620,3,38716,3,1096,2002,2005,,
912,37133,4,37559,4,426,2001,2002,,
912,37559,4,38716,4,1157,2002,2005,,
913,36371,4,36799,5,428,1999,2000,,
913,36799,5,36890,5,91,2000,2000,,
913,36890,5,37397,7,507,2000,2002,,
913,37397,7,37406,6,9,2002,2002,,
913,37406,6,37620,7,214,2002,2002,,
914,38351,5,38716,5,365,2004,2005,,
915,36310,7,36433,8,123,1999,1999,,
915,36433,8,38716,8,2283,1999,2005,,
916,37194,3,37255,4,61,2001,2001,,
916,37255,4,37397,4,142,2001,2002,,
916,37397,4,37620,5,223,2002,2002,,
917,36676,7,36768,4,92,2000,2000,,
917,36768,4,36820,6,52,2000,2000,,
917,36820,6,36890,5,70,2000,2000,,
917,36890,5,38716,6,1826,2000,2005,,
917,36890,6,37133,7,243,2000,2001,,
918,36402,5,36667,6,265,1999,2000,,
918,36667,6,36674,6,7,2000,2000,,
918,36674,6,36676,7,2,2000,2000,,
920,36698,2,37620,3,922,2000,2002,,
920,37620,3,38716,3,1096,2002,2005,,
921,38655,3,38716,3,61,2005,2005,,
922,37915,3,38716,3,801,2003,2005,,
923,36667,4,36707,3,40,2000,2000,,
925,36890,4,37225,4,335,2000,2001,,
925,37225,4,37620,3,395,2001,2002,,
925,37620,3,38716,3,1096,2002,2005,,
926,36676,2,37255,2,579,2000,2001,,
926,37255,2,37762,3,507,2001,2003,,
926,37762,3,38716,3,954,2003,2005,,
927,36667,4,37041,6,374,2000,2001,,
927,37041,6,37216,8,175,2001,2001,,
927,37216,8,37255,4,39,2001,2001,,
927,37255,4,38716,4,1461,2001,2005,,
929,36463,2,37041,3,578,1999,2001,,
929,37041,3,37072,3,31,2001,2001,,
929,37072,3,37406,4,334,2001,2002,,
929,37406,4,38716,4,1310,2002,2005,,
930,37529,4,37771,6,242,2002,2003,,
930,37771,6,37894,5,123,2003,2003,,
930,37894,5,38716,5,822,2003,2005,,
932,37955,2,38716,2,761,2003,2005,,
933,36341,4,37133,4,792,1999,2001,,
933,37133,4,38716,4,1583,2001,2005,,
934,36306,6,37185,7,879,1999,2001,,
935,36890,4,38716,4,1826,2000,2005,,
935,36890,4,37032,5,142,2000,2001,,
935,37032,5,38260,4,1228,2001,2004,,
935,38260,4,38716,4,456,2004,2005,,
937,36890,4,37041,4,151,2000,2001,,
937,37041,4,38493,3,1452,2001,2005,,
937,38493,3,38716,3,223,2005,2005,,
938,37762,3,38716,3,954,2003,2005,,
939,36890,4,38716,4,1826,2000,2005,,
940,36667,7,38716,8,2049,2000,2005,,
940,36667,8,36676,6,9,2000,2000,,
941,38198,4,38716,4,518,2004,2005,,
943,36524,4,38716,4,2192,1999,2005,,
945,37467,3,38716,3,1249,2002,2005,,
946,37063,1,38716,1,1653,2001,2005,,
947,37255,3,38130,3,875,2001,2004,,
947,38130,3,38716,3,586,2004,2005,,
948,36698,5,36890,5,192,2000,2000,,
948,36890,5,38716,5,1826,2000,2005,,
951,37255,4,37399,4,144,2001,2002,,
951,37399,4,38716,4,1317,2002,2005,,
952,37124,3,37255,2,131,2001,2001,,
952,37255,2,37620,3,365,2001,2002,,
952,37620,3,38716,3,1096,2002,2005,,
953,37041,2,38716,3,1675,2001,2005,,
953,37041,3,37397,3,356,2001,2002,,
954,36310,4,37255,5,945,1999,2001,,
954,37255,5,38220,4,965,2001,2004,,
954,38220,4,38716,4,496,2004,2005,,
955,36301,6,36667,6,366,1999,2000,,
955,36667,6,36759,7,92,2000,2000,,
955,36759,7,37032,8,273,2000,2001,,
955,37032,8,37164,7,132,2001,2001,,
955,37164,7,38716,7,1552,2001,2005,,
956,36310,5,36524,6,214,1999,1999,,
956,36524,6,37255,6,731,1999,2001,,
956,37255,6,37406,7,151,2001,2002,,
956,37406,7,38493,6,1087,2002,2005,,
956,38493,6,38716,6,223,2005,2005,,
957,38351,3,38716,3,365,2004,2005,,
958,37832,4,38533,3,701,2003,2005,,
958,38533,3,38716,3,183,2005,2005,,
959,36371,3,38533,3,2162,1999,2005,,
959,38533,3,38716,3,183,2005,2005,,
961,36332,4,38128,5,1796,1999,2004,,
961,38128,5,38321,6,193,2004,2004,,
961,38321,6,38495,6,174,2004,2005,,
961,38495,6,38716,6,221,2005,2005,,
962,36402,4,38716,4,2314,1999,2005,,
963,36890,6,37620,5,730,2000,2002,,
963,37620,5,37823,5,203,2002,2003,,
964,36524,7,36759,6,235,1999,2000,,
964,36759,6,37771,6,1012,2000,2003,,
964,37771,6,38716,6,945,2003,2005,,
966,36524,4,38716,4,2192,1999,2005,,
968,37164,3,37762,3,598,2001,2003,,
968,37762,3,38716,3,954,2003,2005,,
969,36524,3,36759,2,235,1999,2000,,
969,36759,2,37985,3,1226,2000,2003,,
969,37985,3,38716,3,731,2003,2005,,
970,37795,3,38686,2,891,2003,2005,,
970,38686,2,38716,2,30,2005,2005,,
971,37854,5,37985,5,131,2003,2003,,
971,37985,5,38716,5,731,2003,2005,,
973,37041,4,37520,4,479,2001,2002,,
973,37520,4,38716,4,1196,2002,2005,,
974,36371,4,37397,4,1026,1999,2002,,
974,37397,4,37428,5,31,2002,2002,,
974,37802,6,38281,6,479,2003,2004,,
974,38281,6,38716,6,435,2004,2005,,
975,37915,3,38351,3,436,2003,2004,,
975,38351,3,38716,3,365,2004,2005,,
976,37985,3,38716,3,731,2003,2005,,
977,37406,4,37428,4,22,2002,2002,,
977,37428,4,37620,4,192,2002,2002,,
977,37620,4,38716,4,1096,2002,2005,,
978,36890,2,38716,2,1826,2000,2005,,
979,38281,5,38716,5,435,2004,2005,,
981,36301,4,36310,4,9,1999,1999,,
981,36310,4,36676,3,366,1999,2000,,
981,36676,3,37406,3,730,2000,2002,,
981,37406,3,38716,3,1310,2002,2005,,
982,36485,3,38502,3,2017,1999,2005,,
982,38502,3,38716,3,214,2005,2005,,
983,37164,4,38716,4,1552,2001,2005,,
984,37041,3,38716,3,1675,2001,2005,,
985,37498,3,37854,2,356,2002,2003,,
985,37854,2,38716,2,862,2003,2005,,
986,37458,2,37771,2,313,2002,2003,,
986,37771,2,38716,2,945,2003,2005,,
987,38198,2,38716,2,518,2004,2005,,
988,36890,4,37854,4,964,2000,2003,,
988,37854,4,38716,4,862,2003,2005,,
990,36301,4,36667,3,366,1999,2000,,
991,38493,3,38716,3,223,2005,2005,,
992,36310,4,38716,4,2406,1999,2005,,
993,37985,6,38716,6,731,2003,2005,,
994,36698,4,37832,4,1134,2000,2003,,
994,37832,4,38716,4,884,2003,2005,,
995,36890,4,37915,4,1025,2000,2003,,
995,37915,4,38716,4,801,2003,2005,,
996,36667,2,38716,2,2049,2000,2005,,
998,38135,2,38716,2,581,2004,2005,,
1000,36301,3,38716,3,2415,1999,2005,,
1002,36676,5,37620,5,944,2000,2002,,
1002,37620,5,37762,7,142,2002,2003,,
1002,37762,7,37924,7,162,2003,2003,,
1003,38260,4,38716,4,456,2004,2005,,
1004,36310,6,37032,5,722,1999,2001,,
1004,37032,5,37397,6,365,2001,2002,,
1004,37397,6,38716,6,1319,2002,2005,,
1005,36310,2,37762,2,1452,1999,2003,,
1005,37762,2,38131,3,369,2003,2004,,
1005,38131,3,38135,3,4,2004,2004,,
1005,38135,3,38716,3,581,2004,2005,,
1006,37155,4,37397,5,242,2001,2002,,
1006,37397,5,37620,5,223,2002,2002,,
1006,37620,5,38716,7,1096,2002,2005,,
1006,37620,7,38128,6,508,2002,2004,,
1006,38128,6,38136,6,8,2004,2004,,
1006,38136,6,38137,5,1,2004,2004,,
1006,38137,5,38497,4,360,2004,2005,,
1006,38497,4,38716,4,219,2005,2005,,
1007,37032,2,37771,3,739,2001,2003,,
1009,37194,3,38716,3,1522,2001,2005,,
1011,36524,6,36890,6,366,1999,2000,,
1011,36890,6,38716,6,1826,2000,2005,,
1012,36301,5,36524,5,223,1999,1999,,
1014,36402,3,38351,3,1949,1999,2004,,
1014,38351,3,38716,3,365,2004,2005,,
1015,38351,6,38533,5,182,2004,2005,,
1015,38533,5,38716,5,183,2005,2005,,
1016,36301,5,36890,4,589,1999,2000,,
1016,36890,4,38716,4,1826,2000,2005,,
1018,36890,7,37072,7,182,2000,2001,,
1018,37072,7,38220,7,1148,2001,2004,,
1018,38220,7,38716,7,496,2004,2005,,
1019,37032,4,38716,4,1684,2001,2005,,
1020,36371,3,36890,2,519,1999,2000,,
1021,36524,2,37762,2,1238,1999,2003,,
1021,37762,2,38189,3,427,2003,2004,,
1021,38189,3,38351,3,162,2004,2004,,
1021,38351,3,38716,3,365,2004,2005,,
1022,36890,3,37620,4,730,2000,2002,,
1022,37620,4,38716,4,1096,2002,2005,,
1023,36301,5,37946,6,1645,1999,2003,,
1023,37946,6,38716,6,770,2003,2005,,
1024,38655,4,38716,4,61,2005,2005,,
1025,37032,4,37955,4,923,2001,2003,,
1025,37955,4,38716,4,761,2003,2005,,
1026,37406,4,38716,4,1310,2002,2005,,
1027,36310,4,36890,4,580,1999,2000,,
1027,36890,4,37529,4,639,2000,2002,,
1027,38351,4,38716,4,365,2004,2005,,
1028,37124,2,37955,3,831,2001,2003,,
1028,37955,3,38716,3,761,2003,2005,,
1029,36768,4,37985,4,1217,2000,2003,,
1029,37985,4,38716,4,731,2003,2005,,
1030,36433,4,36829,3,396,1999,2000,,
1030,36829,3,38221,3,1392,2000,2004,,
1030,38221,3,38716,3,495,2004,2005,,
1031,37854,6,38716,6,862,2003,2005,,
1032,36301,4,36860,3,559,1999,2000,,
1032,36860,3,38312,3,1452,2000,2004,,
1032,38312,3,38716,3,404,2004,2005,,
1033,37255,3,38137,2,882,2001,2004,,
1033,38137,2,38716,2,579,2004,2005,,
1034,36524,6,37041,7,517,1999,2001,,
1034,37041,7,37102,6,61,2001,2001,,
1034,37102,6,37406,8,304,2001,2002,,
1034,37406,8,37458,7,52,2002,2002,,
1034,37458,7,38290,7,832,2002,2004,,
1034,38290,7,38655,5,365,2004,2005,,
1034,38655,5,38716,5,61,2005,2005,,
1035,36890,4,38716,4,1826,2000,2005,,
1036,36676,6,37498,7,822,2000,2002,,
1038,36524,7,36698,7,174,1999,2000,,
1038,36698,7,37529,7,831,2000,2002,,
1038,37529,7,38716,7,1187,2002,2005,,
1040,36890,2,38716,2,1826,2000,2005,,
1045,36667,4,38716,4,2049,2000,2005,,
1046,36301,5,37762,4,1461,1999,2003,,
1046,37762,4,38351,4,589,2003,2004,,
1046,38351,4,38716,4,365,2004,2005,,
1048,36698,5,38716,5,2018,2000,2005,,
1049,36301,6,36524,6,223,1999,1999,,
1049,36524,6,37255,7,731,1999,2001,,
1050,37620,5,38716,5,1096,2002,2005,,
1051,37397,4,37620,5,223,2002,2002,,
1051,37620,5,38312,4,692,2002,2004,,
1051,38312,4,38716,4,404,2004,2005,,
1052,37032,5,37255,5,223,2001,2001,,
1052,37255,5,37762,5,507,2001,2003,,
1052,37762,5,38137,6,375,2003,2004,,
1052,38137,6,38168,7,31,2004,2004,,
1053,37032,4,37095,4,63,2001,2001,,
1053,37095,4,38716,4,1621,2001,2005,,
1054,37032,2,37164,3,132,2001,2001,,
1054,37164,3,38716,3,1552,2001,2005,,
1055,37985,3,38716,3,731,2003,2005,,
1056,37894,4,38716,4,822,2003,2005,,
1057,36860,4,37428,4,568,2000,2002,,
1057,37428,4,38716,4,1288,2002,2005,,
1058,36667,3,38716,3,2049,2000,2005,,
1059,36667,2,38716,2,2049,2000,2005,,
1060,36301,5,36524,5,223,1999,1999,,
1060,36524,5,38716,5,2192,1999,2005,,
1060,36524,5,38128,5,1604,1999,2004,,
1060,38128,5,38716,5,588,2004,2005,,
1061,37397,2,38716,2,1319,2002,2005,,
1062,37620,5,37854,5,234,2002,2003,,
1062,37854,5,38716,5,862,2003,2005,,
1063,37255,2,37397,3,142,2001,2002,,
1063,37397,3,38716,3,1319,2002,2005,,
1064,36790,4,37620,5,830,2000,2002,,
1064,37620,5,37771,5,151,2002,2003,,
1064,37771,5,38716,5,945,2003,2005,,
1065,37194,2,37255,2,61,2001,2001,,
1065,37255,2,37403,3,148,2001,2002,,
1065,37403,3,38716,3,1313,2002,2005,,
1066,36524,3,38198,4,1674,1999,2004,,
1066,38198,4,38716,4,518,2004,2005,,
1068,36301,2,38716,2,2415,1999,2005,,
1069,38132,1,38716,1,584,2004,2005,,
1070,37035,2,37216,2,181,2001,2001,,
1070,37216,2,37397,3,181,2001,2002,,
1070,37397,3,38716,3,1319,2002,2005,,
1071,36301,6,36363,7,62,1999,1999,,
1071,36363,7,36524,7,161,1999,1999,,
1072,36829,3,37529,3,700,2000,2002,,
1072,37529,3,37620,3,91,2002,2002,,
1072,37620,3,38716,3,1096,2002,2005,,
1073,37550,3,38716,3,1166,2002,2005,,
1074,37550,3,38716,3,1166,2002,2005,,
1075,36301,5,36310,4,9,1999,1999,,
1075,36310,4,37397,4,1087,1999,2002,,
1075,37397,4,38493,4,1096,2002,2005,,
1075,38493,4,38716,4,223,2005,2005,,
1078,36454,6,37041,6,587,1999,2001,,
1078,37041,6,37620,6,579,2001,2002,,
1078,37620,6,38159,6,539,2002,2004,,
1080,36301,5,36799,4,498,1999,2000,,
1080,36799,4,37397,6,598,2000,2002,,
1080,37397,6,38716,7,1319,2002,2005,,
1080,37397,7,38716,8,1319,2002,2005,,
1080,37498,7,38716,7,1218,2002,2005,,
1081,36820,6,37255,6,435,2000,2001,,
1081,37255,6,37437,7,182,2001,2002,,
1081,37437,7,38716,7,1279,2002,2005,,
1084,36301,3,36890,2,589,1999,2000,,
1085,36310,2,38716,2,2406,1999,2005,,
1086,37985,3,38716,3,731,2003,2005,,
1087,38260,6,38716,6,456,2004,2005,,
1088,36860,5,37397,5,537,2000,2002,,
1088,37397,5,37985,5,588,2002,2003,,
1088,37985,5,38128,6,143,2003,2004,,
1088,38128,6,38716,6,588,2004,2005,,
1089,36737,5,38655,5,1918,2000,2005,,
1089,38655,5,38716,5,61,2005,2005,,
1090,36860,5,38493,5,1633,2000,2005,,
1090,38493,5,38716,5,223,2005,2005,,
1092,38351,4,38716,4,365,2004,2005,,
1093,36890,4,37620,4,730,2000,2002,,
1093,37620,4,38493,4,873,2002,2005,,
1093,38493,4,38716,4,223,2005,2005,,
1094,37590,4,38716,4,1126,2002,2005,,
1095,37164,4,38220,4,1056,2001,2004,,
1095,38220,4,38716,4,496,2004,2005,,
1096,37399,5,38716,5,1317,2002,2005,,
1097,37397,3,37924,4,527,2002,2003,,
1097,37924,4,38137,3,213,2003,2004,,
1097,38137,3,38716,3,579,2004,2005,,
1098,36310,3,36668,3,358,1999,2000,,
1098,36668,3,38716,3,2048,2000,2005,,
1099,36667,3,38716,3,2049,2000,2005,,
1100,37762,2,38716,2,954,2003,2005,,
1101,36301,4,37255,4,954,1999,2001,,
1101,37255,4,37863,4,608,2001,2003,,
1101,37863,4,38493,5,630,2003,2005,,
1101,38493,5,38716,5,223,2005,2005,,
1102,37985,6,38716,6,731,2003,2005,,
1103,36792,7,37194,8,402,2000,2001,,
1103,37194,8,38716,8,1522,2001,2005,,
1104,37255,2,38716,2,1461,2001,2005,,
1105,36667,3,38716,3,2049,2000,2005,,
1106,36433,5,37529,6,1096,1999,2002,,
1106,37529,6,38716,6,1187,2002,2005,,
1108,36424,4,36463,4,39,1999,1999,,
1108,36463,4,37402,3,939,1999,2002,,
1108,37402,3,38716,3,1314,2002,2005,,
1109,36371,4,36524,4,153,1999,1999,,
1109,36524,4,37467,3,943,1999,2002,,
1109,37467,3,38716,3,1249,2002,2005,,
1111,38137,4,38716,4,579,2004,2005,,
1113,36524,7,37093,7,569,1999,2001,,
1113,37093,7,38716,7,1623,2001,2005,,
1114,36424,6,36890,6,466,1999,2000,,
1114,36890,6,38716,8,1826,2000,2005,,
1115,36524,5,36890,6,366,1999,2000,,
1115,36890,6,37041,5,151,2000,2001,,
1115,37041,5,38716,5,1675,2001,2005,,
1116,38128,4,38716,4,588,2004,2005,,
1118,36310,4,37402,5,1092,1999,2002,,
1118,37402,5,37458,4,56,2002,2002,,
1118,37458,4,38128,4,670,2002,2004,,
1118,38128,4,38493,3,365,2004,2005,,
1118,38493,3,38716,3,223,2005,2005,,
1119,37032,3,37771,4,739,2001,2003,,
1119,37771,4,38128,3,357,2003,2004,,
1119,38128,3,38716,3,588,2004,2005,,
1120,36310,4,38716,4,2406,1999,2005,,
1121,36310,4,36524,4,214,1999,1999,,
1121,36524,4,38716,4,2192,1999,2005,,
1121,36524,4,37124,4,600,1999,2001,,
1121,37124,4,38716,4,1592,2001,2005,,
1122,37406,3,37894,3,488,2002,2003,,
1122,37894,3,37985,4,91,2003,2003,,
1122,37985,4,38716,4,731,2003,2005,,
1123,36671,4,37428,4,757,2000,2002,,
1123,37428,4,38716,4,1288,2002,2005,,
1124,38351,4,38716,4,365,2004,2005,,
1125,37620,3,38716,4,1096,2002,2005,,
1125,37620,4,38716,4,1096,2002,2005,,
1126,37185,5,37520,6,335,2001,2002,,
1126,37520,6,37863,6,343,2002,2003,,
1126,37863,6,38716,6,853,2003,2005,,
1127,37458,2,38716,2,1258,2002,2005,,
1128,38351,2,38716,2,365,2004,2005,,
1130,38128,5,38716,5,588,2004,2005,,
1131,37550,3,38716,3,1166,2002,2005,,
1132,36676,3,37032,3,356,2000,2001,,
1132,37032,3,37428,4,396,2001,2002,,
1132,37428,4,37437,5,9,2002,2002,,
1132,37437,5,37924,5,487,2002,2003,,
1132,37924,5,38716,5,792,2003,2005,,
1133,37762,4,38716,4,954,2003,2005,,
1134,36890,4,37467,3,577,2000,2002,,
1134,37467,3,38716,3,1249,2002,2005,,
1135,36332,5,36676,5,344,1999,2000,,
1135,36676,5,37063,6,387,2000,2001,,
1135,37063,6,37620,7,557,2001,2002,,
1135,37620,7,37863,6,243,2002,2003,,
1135,37863,6,37955,8,92,2003,2003,,
1135,37955,8,38493,7,538,2003,2005,,
1135,38493,7,38716,7,223,2005,2005,,
1136,37124,3,37467,4,343,2001,2002,,
1136,37467,4,38716,4,1249,2002,2005,,
1137,36454,3,38716,3,2262,1999,2005,,
1138,36799,2,38716,2,1917,2000,2005,,
1139,36524,7,37255,7,731,1999,2001,,
1139,37255,7,37620,7,365,2001,2002,,
1139,37620,7,37985,8,365,2002,2003,,
1140,37072,2,37529,3,457,2001,2002,,
1140,37529,3,38716,3,1187,2002,2005,,
1141,36890,4,38716,4,1826,2000,2005,,
1142,37032,2,38716,2,1684,2001,2005,,
1143,37194,4,38351,4,1157,2001,2004,,
1143,38351,4,38716,4,365,2004,2005,,
1145,36310,2,37397,3,1087,1999,2002,,
1145,37397,3,37985,3,588,2002,2003,,
1145,37985,3,38716,3,731,2003,2005,,
1147,36737,3,37255,3,518,2000,2001,,
1147,37255,3,37620,4,365,2001,2002,,
1147,37620,4,38716,4,1096,2002,2005,,
1148,36341,4,37856,4,1515,1999,2003,,
1148,37856,4,38716,4,860,2003,2005,,
1149,36310,4,37976,4,1666,1999,2003,,
1149,37976,4,38716,4,740,2003,2005,,
1150,36301,4,36524,4,223,1999,1999,,
1150,36524,4,38716,4,2192,1999,2005,,
1150,36524,4,37255,4,731,1999,2001,,
1150,37255,4,38716,4,1461,2001,2005,,
1151,38128,4,38716,4,588,2004,2005,,
1152,36667,2,37985,3,1318,2000,2003,,
1152,37985,3,38716,3,731,2003,2005,,
1153,36670,4,37039,4,369,2000,2001,,
1153,37039,4,37255,5,216,2001,2001,,
1153,37255,5,38220,4,965,2001,2004,,
1153,38220,4,38716,4,496,2004,2005,,
1154,36304,3,36524,3,220,1999,1999,,
1154,36524,3,37406,3,882,1999,2002,,
1154,37406,3,38251,3,845,2002,2004,,
1154,38251,3,38716,3,465,2004,2005,,
1155,37032,3,38716,3,1684,2001,2005,,
1156,37620,2,38716,2,1096,2002,2005,,
1157,36676,3,38716,3,2040,2000,2005,,
1159,37498,6,38716,6,1218,2002,2005,,
1160,36890,3,37985,3,1095,2000,2003,,
1160,37985,3,38716,3,731,2003,2005,,
1161,38128,4,38716,4,588,2004,2005,,
1162,36524,1,38716,1,2192,1999,2005,,
1163,36301,3,37397,6,1096,1999,2002,,
1163,37397,6,38716,8,1319,2002,2005,,
1163,37397,8,37406,5,9,2002,2002,,
1163,37406,5,37559,4,153,2002,2002,,
1164,37397,4,37406,6,9,2002,2002,,
1164,37406,6,37520,7,114,2002,2002,,
1164,37520,7,37762,6,242,2002,2003,,
1164,37762,6,38312,6,550,2003,2004,,
1164,38312,6,38716,6,404,2004,2005,,
1165,36890,5,37255,5,365,2000,2001,,
1165,37255,5,37771,4,516,2001,2003,,
1165,37771,4,38716,4,945,2003,2005,,
1166,36667,3,37620,3,953,2000,2002,,
1167,36362,6,37915,5,1553,1999,2003,,
1167,37915,5,38716,5,801,2003,2005,,
1168,36463,6,37498,5,1035,1999,2002,,
1168,37498,5,38716,5,1218,2002,2005,,
1169,36301,5,36310,5,9,1999,1999,,
1169,36310,5,36890,6,580,1999,2000,,
1169,36890,6,37255,6,365,2000,2001,,
1169,37620,4,38716,4,1096,2002,2005,,
1170,37762,5,38716,5,954,2003,2005,,
1171,36332,6,38137,6,1805,1999,2004,,
1171,38137,6,38716,6,579,2004,2005,,
1173,36301,5,36362,6,61,1999,1999,,
1173,36362,6,36667,5,305,1999,2000,,
1176,36890,4,37523,4,633,2000,2002,,
1176,37523,4,38716,4,1193,2002,2005,,
1177,37771,2,38716,2,945,2003,2005,,
1178,36759,5,38351,4,1592,2000,2004,,
1178,38351,4,38716,4,365,2004,2005,,
1181,37255,5,37397,5,142,2001,2002,,
1181,37397,5,38137,5,740,2002,2004,,
1181,38137,5,38716,5,579,2004,2005,,
1182,36524,7,38716,7,2192,1999,2005,,
1183,37620,2,38128,2,508,2002,2004,,
1183,38128,2,38716,2,588,2004,2005,,
1185,36515,2,38137,2,1622,1999,2004,,
1185,38137,2,38716,2,579,2004,2005,,
1186,36524,3,38137,2,1613,1999,2004,,
1186,38137,2,38716,2,579,2004,2005,,
1187,36890,6,37985,6,1095,2000,2003,,
1187,37985,6,38716,6,731,2003,2005,,
1188,36402,2,36707,2,305,1999,2000,,
1188,36707,2,37032,3,325,2000,2001,,
1188,37032,3,38716,3,1684,2001,2005,,
1188,37032,3,38351,4,1319,2001,2004,,
1188,38351,4,38716,4,365,2004,2005,,
1189,36301,2,36676,2,375,1999,2000,,
1189,36676,2,36890,3,214,2000,2000,,
1189,36890,3,37041,3,151,2000,2001,,
1190,38321,4,38716,4,395,2004,2005,,
1192,36301,3,38716,3,2415,1999,2005,,
1193,37771,6,38716,6,945,2003,2005,,
1194,36362,4,36463,4,101,1999,1999,,
1194,36463,4,36524,4,61,1999,1999,,
1194,36524,4,37253,4,729,1999,2001,,
1194,37253,4,38716,4,1463,2001,2005,,
1195,36301,5,37126,6,825,1999,2001,,
1195,37126,6,38128,5,1002,2001,2004,,
1195,38128,5,38716,5,588,2004,2005,,
1196,37041,4,38716,4,1675,2001,2005,,
1197,36524,5,36667,6,143,1999,2000,,
1197,36667,6,37559,6,892,2000,2002,,
1197,37559,6,37762,7,203,2002,2003,,
1197,37762,7,37823,6,61,2003,2003,,
1197,37823,6,38716,6,893,2003,2005,,
1198,37771,4,38716,4,945,2003,2005,,
1199,36829,4,38716,4,1887,2000,2005,,
1200,37255,2,38716,2,1461,2001,2005,,
1203,37771,2,38716,2,945,2003,2005,,
1204,37255,2,38716,2,1461,2001,2005,,
1205,37406,3,37985,4,579,2002,2003,,
1205,37985,4,38133,4,148,2003,2004,,
1205,38133,4,38716,4,583,2004,2005,,
1206,36524,4,37590,4,1066,1999,2002,,
1206,37590,4,37985,4,395,2002,2003,,
1206,37985,4,38716,5,731,2003,2005,,
1206,37985,5,38716,5,731,2003,2005,,
1207,36667,4,36676,4,9,2000,2000,,
1207,36676,4,38716,4,2040,2000,2005,,
1208,37041,4,37924,4,883,2001,2003,,
1208,37924,4,38493,5,569,2003,2005,,
1208,38493,5,38625,4,132,2005,2005,,
1208,38625,4,38716,4,91,2005,2005,,
1210,36393,6,37034,5,641,1999,2001,,
1210,37034,5,38716,5,1682,2001,2005,,
1211,36524,5,36890,5,366,1999,2000,,
1211,36890,5,37124,6,234,2000,2001,,
1211,37124,6,37802,6,678,2001,2003,,
1211,37802,6,38716,6,914,2003,2005,,
1212,37255,2,37955,3,700,2001,2003,,
1212,37955,3,38716,3,761,2003,2005,,
1213,37041,3,38716,3,1675,2001,2005,,
1214,36675,3,37255,3,580,2000,2001,,
1214,37255,3,38716,3,1461,2001,2005,,
1215,38351,5,38502,6,151,2004,2005,,
1215,38502,6,38716,6,214,2005,2005,,
1216,37529,4,38716,4,1187,2002,2005,,
1217,36667,8,36737,8,70,2000,2000,,
1220,36667,3,38716,3,2049,2000,2005,,
1221,36676,2,38716,2,2040,2000,2005,,
1222,36667,3,38716,3,2049,2000,2005,,
1223,37102,3,38260,3,1158,2001,2004,,
1223,38260,3,38716,3,456,2004,2005,,
1224,37397,2,38502,2,1105,2002,2005,,
1224,38502,2,38716,2,214,2005,2005,,
1225,37985,3,38716,3,731,2003,2005,,
1226,36728,4,37041,4,313,2000,2001,,
1226,37041,4,37397,4,356,2001,2002,,
1226,37397,4,37489,5,92,2002,2002,,
1226,37489,5,37894,6,405,2002,2003,,
1226,37894,6,38493,6,599,2003,2005,,
1226,38493,6,38716,6,223,2005,2005,,
1227,36676,4,37255,5,579,2000,2001,,
1228,37216,4,37620,4,404,2001,2002,,
1229,36310,5,36890,5,580,1999,2000,,
1229,36890,5,37435,4,545,2000,2002,,
1229,37435,4,37915,4,480,2002,2003,,
1229,37915,4,38716,4,801,2003,2005,,
1230,38351,2,38502,2,151,2004,2005,,
1230,38502,2,38716,2,214,2005,2005,,
1232,37406,4,38716,4,1310,2002,2005,,
1233,37255,3,37765,4,510,2001,2003,,
1234,36424,3,38137,4,1713,1999,2004,,
1234,38137,4,38716,4,579,2004,2005,,
1235,36524,2,37762,2,1238,1999,2003,,
1235,37762,2,38220,3,458,2003,2004,,
1235,38220,3,38351,3,131,2004,2004,,
1235,38351,3,38716,3,365,2004,2005,,
1236,36332,5,36829,4,497,1999,2000,,
1236,36829,4,37590,4,761,2000,2002,,
1236,37590,4,38502,4,912,2002,2005,,
1236,38502,4,38716,4,214,2005,2005,,
1238,36890,5,37894,5,1004,2000,2003,,
1238,37894,5,38716,5,822,2003,2005,,
1239,36301,4,37406,4,1105,1999,2002,,
1239,37406,4,37550,5,144,2002,2002,,
1239,37550,5,37771,6,221,2002,2003,,
1239,37771,6,38716,6,945,2003,2005,,
1240,36463,4,36829,4,366,1999,2000,,
1240,36829,4,36890,5,61,2000,2000,,
1240,36890,5,37397,6,507,2000,2002,,
1240,37397,6,37428,6,31,2002,2002,,
1240,37428,6,38312,6,884,2002,2004,,
1240,38312,6,38716,6,404,2004,2005,,
1241,36362,2,37398,3,1036,1999,2002,,
1241,37398,3,38716,3,1318,2002,2005,,
1244,37124,5,38716,5,1592,2001,2005,,
1245,37067,4,38716,4,1649,2001,2005,,
1246,37216,6,37397,6,181,2001,2002,,
1246,37397,6,37771,6,374,2002,2003,,
1246,37771,6,37985,5,214,2003,2003,,
1246,37985,5,38137,4,152,2003,2004,,
1248,36524,4,37406,3,882,1999,2002,,
1249,37032,4,37102,6,70,2001,2001,,
1249,37102,6,37985,5,883,2001,2003,,
1249,37985,5,38716,5,731,2003,2005,,
1251,37032,7,37246,8,214,2001,2001,,
1251,37246,8,37255,7,9,2001,2001,,
1251,37255,7,37397,8,142,2001,2002,,
1252,36524,5,37041,6,517,1999,2001,,
1252,37041,6,37406,7,365,2001,2002,,
1252,37894,8,38716,8,822,2003,2005,,
1256,37194,4,37823,4,629,2001,2003,,
1256,37823,4,38716,4,893,2003,2005,,
1257,36524,4,38716,4,2192,1999,2005,,
1258,38159,3,38716,3,557,2004,2005,,
1259,37397,5,38625,4,1228,2002,2005,,
1259,38625,4,38716,4,91,2005,2005,,
1260,36672,4,38137,4,1465,2000,2004,,
1260,38137,4,38716,4,579,2004,2005,,
1261,36402,4,36698,3,296,1999,2000,,
1261,36698,3,38159,3,1461,2000,2004,,
1261,38159,3,38251,3,92,2004,2004,,
1261,38251,3,38716,3,465,2004,2005,,
1262,37620,3,38716,3,1096,2002,2005,,
1263,37406,5,37762,6,356,2002,2003,,
1263,37762,6,37771,7,9,2003,2003,,
1263,37771,7,38220,6,449,2003,2004,,
1263,38220,6,38716,6,496,2004,2005,,
1264,36301,3,38716,3,2415,1999,2005,,
1266,36890,3,37620,4,730,2000,2002,,
1266,37620,4,38716,4,1096,2002,2005,,
1267,37406,3,38716,3,1310,2002,2005,,
1268,36524,7,37893,6,1369,1999,2003,,
1268,37893,6,38716,6,823,2003,2005,,
1269,38499,3,38716,3,217,2005,2005,,
1270,38716,3,38716,3,0,2005,2005,,
1271,36667,3,38351,3,1684,2000,2004,,
1271,38351,3,38716,3,365,2004,2005,,
1272,36667,3,38716,3,2049,2000,2005,,
1273,38168,4,38716,4,548,2004,2005,,
1274,36707,4,38189,4,1482,2000,2004,,
1274,38189,4,38716,4,527,2004,2005,,
1275,36524,5,38716,5,2192,1999,2005,,
1276,37406,5,37489,4,83,2002,2002,,
1276,37489,4,37985,5,496,2002,2003,,
1276,37985,5,38716,5,731,2003,2005,,
1277,36799,3,37985,1,1186,2000,2003,,
1277,37985,1,38716,1,731,2003,2005,,
1279,37550,5,37771,7,221,2002,2003,,
1279,37985,8,38716,8,731,2003,2005,,
1280,36676,3,38716,3,2040,2000,2005,,
1281,38563,3,38716,3,153,2005,2005,,
1283,36393,5,38716,5,2323,1999,2005,,
1284,36301,3,36433,3,132,1999,1999,,
1285,36676,3,36737,2,61,2000,2000,,
1285,36737,2,37041,4,304,2000,2001,,
1285,37041,4,37225,4,184,2001,2001,,
1285,37225,4,37766,4,541,2001,2003,,
1285,37766,4,37985,4,219,2003,2003,,
1285,37985,4,38716,4,731,2003,2005,,
1286,36676,2,37550,2,874,2000,2002,,
1286,37550,2,38137,2,587,2002,2004,,
1286,38137,2,38716,2,579,2004,2005,,
1287,36890,5,37032,8,142,2000,2001,,
1287,37032,8,37041,7,9,2001,2001,,
1288,38281,4,38716,4,435,2004,2005,,
1289,36463,1,38716,1,2253,1999,2005,,
1290,36463,3,36524,3,61,1999,1999,,
1290,36524,3,37093,3,569,1999,2001,,
1290,37093,3,38716,3,1623,2001,2005,,
1291,36790,2,37620,3,830,2000,2002,,
1291,37620,3,38351,2,731,2002,2004,,
1291,38351,2,38716,2,365,2004,2005,,
1292,37550,3,38716,3,1166,2002,2005,,
1293,36890,3,37225,3,335,2000,2001,,
1293,37225,3,37489,3,264,2001,2002,,
1293,37489,3,38716,3,1227,2002,2005,,
1294,36301,3,37133,3,832,1999,2001,,
1294,37133,3,37255,3,122,2001,2001,,
1294,37255,3,37397,4,142,2001,2002,,
1294,37397,4,37985,4,588,2002,2003,,
1294,37985,4,38716,4,731,2003,2005,,
1295,37620,3,38716,3,1096,2002,2005,,
1296,37406,3,38716,3,1310,2002,2005,,
1297,37397,3,37620,4,223,2002,2002,,
1297,37620,4,38716,4,1096,2002,2005,,
1298,36667,2,37620,1,953,2000,2002,,
1298,37620,1,38716,1,1096,2002,2005,,
1299,37620,2,38716,2,1096,2002,2005,,
1300,36454,5,37072,5,618,1999,2001,,
1301,36491,3,38128,3,1637,1999,2004,,
1301,38128,3,38716,3,588,2004,2005,,
1302,36820,3,37768,3,948,2000,2003,,
1302,37768,3,38716,3,948,2003,2005,,
1303,37032,3,38137,3,1105,2001,2004,,
1303,38137,3,38716,3,579,2004,2005,,
1305,37985,6,38716,6,731,2003,2005,,
1306,36402,5,36524,6,122,1999,1999,,
1306,36524,6,37762,6,1238,1999,2003,,
1306,37762,6,38716,6,954,2003,2005,,
1309,36667,3,38137,3,1470,2000,2004,,
1309,38137,3,38716,3,579,2004,2005,,
1310,37769,3,38351,2,582,2003,2004,,
1310,38351,2,38716,2,365,2004,2005,,
1311,37164,5,37620,6,456,2001,2002,,
1311,37620,6,38499,6,879,2002,2005,,
1311,38499,6,38716,6,217,2005,2005,,
1312,37467,3,38716,3,1249,2002,2005,,
1314,37397,3,38716,4,1319,2002,2005,,
1314,38716,4,38716,4,0,2005,2005,,
1315,36301,2,37032,2,731,1999,2001,,
1315,37032,2,37489,2,457,2001,2002,,
1316,37793,6,37985,5,192,2003,2003,,
1316,37985,5,38137,6,152,2003,2004,,
1316,38137,6,38716,6,579,2004,2005,,
1317,36676,3,38716,3,2040,2000,2005,,
1318,37397,3,38716,3,1319,2002,2005,,
1320,37041,7,37498,8,457,2001,2002,,
1321,37155,2,38716,2,1561,2001,2005,,
1322,37771,2,38716,2,945,2003,2005,,
1323,36402,3,38312,3,1910,1999,2004,,
1323,38312,3,38716,3,404,2004,2005,,
1324,37093,2,38716,2,1623,2001,2005,,
1326,36463,3,37041,3,578,1999,2001,,
1326,37041,3,37406,4,365,2001,2002,,
1326,37406,4,37985,4,579,2002,2003,,
1326,37985,4,38716,4,731,2003,2005,,
1327,36301,4,37397,4,1096,1999,2002,,
1327,37397,4,38351,4,954,2002,2004,,
1327,38351,4,38716,4,365,2004,2005,,
1329,36524,6,36768,7,244,1999,2000,,
1330,36524,4,37397,6,873,1999,2002,,
1330,37397,6,37498,5,101,2002,2002,,
1330,37498,5,38716,5,1218,2002,2005,,
1331,38290,2,38716,2,426,2004,2005,,
1333,36524,5,36676,5,152,1999,2000,,
1333,36676,5,38716,5,2040,2000,2005,,
1335,37620,2,38351,3,731,2002,2004,,
1335,38351,3,38716,3,365,2004,2005,,
1336,37492,2,38716,2,1224,2002,2005,,
1337,37985,3,38716,3,731,2003,2005,,
1339,36667,4,38716,4,2049,2000,2005,,
1341,37620,4,38625,4,1005,2002,2005,,
1341,38625,4,38716,4,91,2005,2005,,
1342,36676,3,37406,3,730,2000,2002,,
1342,37406,3,38137,4,731,2002,2004,,
1342,38137,4,38716,4,579,2004,2005,,
1344,36524,6,37955,7,1431,1999,2003,,
1344,37955,7,38716,8,761,2003,2005,,
1344,38716,8,38716,8,0,2005,2005,,
1346,36524,4,38137,4,1613,1999,2004,,
1346,38137,4,38716,4,579,2004,2005,,
1347,36301,5,36393,6,92,1999,1999,,
1347,36393,6,37397,6,1004,1999,2002,,
1348,36851,2,37620,2,769,2000,2002,,
1348,37620,2,38716,2,1096,2002,2005,,
1349,36310,5,37559,6,1249,1999,2002,,
1349,37559,6,38493,5,934,2002,2005,,
1349,38493,5,38716,5,223,2005,2005,,
1350,36433,4,37041,4,608,1999,2001,,
1350,37041,4,37559,5,518,2001,2002,,
1350,37559,5,38137,4,578,2002,2004,,
1351,36301,5,37255,4,954,1999,2001,,
1351,37255,4,38321,4,1066,2001,2004,,
1351,38321,4,38716,4,395,2004,2005,,
1352,36494,5,37157,4,663,1999,2001,,
1352,37157,4,38128,4,971,2001,2004,,
1352,38128,4,38716,4,588,2004,2005,,
1353,38342,4,38716,4,374,2004,2005,,
1354,36820,4,38290,3,1470,2000,2004,,
1354,38290,3,38716,3,426,2004,2005,,
1355,38312,3,38716,3,404,2004,2005,,
1358,36301,4,36890,4,589,1999,2000,,
1359,36524,4,36667,4,143,1999,2000,,
1359,36667,4,37255,4,588,2000,2001,,
1359,37924,4,38128,4,204,2003,2004,,
1359,38128,4,38716,4,588,2004,2005,,
1360,36301,5,37041,4,740,1999,2001,,
1360,37041,4,38260,4,1219,2001,2004,,
1360,38260,4,38716,4,456,2004,2005,,
1361,37255,3,37620,4,365,2001,2002,,
1361,37620,4,37762,4,142,2002,2003,,
1361,37762,4,38716,5,954,2003,2005,,
1361,37762,5,37885,5,123,2003,2003,,
1361,37885,5,37894,4,9,2003,2003,,
1361,37894,4,38281,4,387,2003,2004,,
1361,38281,4,38290,6,9,2004,2004,,
1362,36463,4,37985,4,1522,1999,2003,,
1362,37985,4,38716,4,731,2003,2005,,
1363,37255,4,37397,4,142,2001,2002,,
1363,37397,4,38716,4,1319,2002,2005,,
1364,38594,2,38716,2,122,2005,2005,,
1365,37397,4,38716,4,1319,2002,2005,,
1366,38220,2,38716,2,496,2004,2005,,
1367,37164,4,38716,4,1552,2001,2005,,
1368,37032,4,38716,4,1684,2001,2005,,
1370,36371,4,36728,4,357,1999,2000,,
1370,36728,4,38716,4,1988,2000,2005,,
1374,36301,5,36829,5,528,1999,2000,,
1374,36829,5,37041,4,212,2000,2001,,
1374,37041,4,37216,4,175,2001,2001,,
1374,37216,4,38502,4,1286,2001,2005,,
1374,38502,4,38716,4,214,2005,2005,,
1375,37620,3,38716,3,1096,2002,2005,,
1376,37489,1,38716,1,1227,2002,2005,,
1377,37762,3,38716,3,954,2003,2005,,
1378,37255,3,38716,3,1461,2001,2005,,
1379,37399,4,38716,4,1317,2002,2005,,
1380,36669,3,37041,4,372,2000,2001,,
1380,37041,4,38716,6,1675,2001,2005,,
1380,37041,6,37127,4,86,2001,2001,,
1380,37127,4,37185,6,58,2001,2001,,
1380,37185,6,37620,4,435,2001,2002,,
1380,37620,4,38716,4,1096,2002,2005,,
1380,37620,4,38502,3,882,2002,2005,,
1380,38502,3,38716,3,214,2005,2005,,
1381,36676,4,37124,6,448,2000,2001,,
1381,37124,6,37156,8,32,2001,2001,,
1381,37156,8,37185,4,29,2001,2001,,
1381,37185,4,37255,4,70,2001,2001,,
1382,37216,4,37428,5,212,2001,2002,,
1382,37428,5,38716,5,1288,2002,2005,,
1383,37406,4,37620,3,214,2002,2002,,
1383,37620,3,38128,3,508,2002,2004,,
1383,38128,3,38716,3,588,2004,2005,,
1384,37620,3,38716,4,1096,2002,2005,,
1384,37620,4,38260,3,640,2002,2004,,
1384,38260,3,38716,3,456,2004,2005,,
1385,37037,3,37063,4,26,2001,2001,,
1385,37063,4,37255,4,192,2001,2001,,
1385,37255,4,37406,6,151,2001,2002,,
1385,37406,6,37550,7,144,2002,2002,,
1385,37550,7,37620,4,70,2002,2002,,
1385,37620,4,38716,5,1096,2002,2005,,
1385,37620,5,38716,5,1096,2002,2005,,
1386,38351,4,38716,4,365,2004,2005,,
1387,37063,5,37771,7,708,2001,2003,,
1387,37771,7,38716,7,945,2003,2005,,
1388,36667,2,37985,2,1318,2000,2003,,
1388,37985,2,38716,2,731,2003,2005,,
1389,36890,3,38716,3,1826,2000,2005,,
1390,37397,4,37620,6,223,2002,2002,,
1390,37620,6,37985,6,365,2002,2003,,
1390,37985,6,38198,5,213,2003,2004,,
1390,38198,5,38716,5,518,2004,2005,,
1391,37397,4,37406,5,9,2002,2002,,
1391,37406,5,37529,4,123,2002,2002,,
1391,37529,4,38716,4,1187,2002,2005,,
1392,36332,5,36371,7,39,1999,1999,,
1392,36371,7,36393,6,22,1999,1999,,
1393,36799,2,38716,2,1917,2000,2005,,
1395,37216,4,37620,5,404,2001,2002,,
1395,37620,5,37762,7,142,2002,2003,,
1395,37762,7,38716,8,954,2003,2005,,
1396,38128,2,38716,2,588,2004,2005,,
1397,37581,3,38716,3,1135,2002,2005,,
1399,37063,4,37823,4,760,2001,2003,,
1399,37823,4,38716,4,893,2003,2005,,
1400,37762,5,38716,5,954,2003,2005,,
1401,36524,6,36676,3,152,1999,2000,,
1401,36676,3,37041,3,365,2000,2001,,
1401,37041,3,37185,4,144,2001,2001,,
1401,37185,4,37397,4,212,2001,2002,,
1401,37397,4,37529,5,132,2002,2002,,
1401,37529,5,38716,5,1187,2002,2005,,
1402,36362,6,36368,5,6,1999,1999,,
1402,36368,5,36676,7,308,1999,2000,,
1402,36676,7,37620,8,944,2000,2002,,
1403,37255,5,37397,6,142,2001,2002,,
1403,37397,6,37406,7,9,2002,2002,,
1403,37406,7,38716,7,1310,2002,2005,,
1403,37406,7,37559,7,153,2002,2002,,
1403,37559,7,37590,6,31,2002,2002,,
1403,37590,6,37620,8,30,2002,2002,,
1403,38290,7,38686,6,396,2004,2005,,
1403,38686,6,38716,6,30,2005,2005,,
1404,36301,6,36310,6,9,1999,1999,,
1404,36310,6,37529,6,1219,1999,2002,,
1404,37529,6,37620,7,91,2002,2002,,
1404,37620,7,37955,7,335,2002,2003,,
1405,36364,2,37762,2,1398,1999,2003,,
1405,37762,2,38716,2,954,2003,2005,,
1406,37255,3,38716,3,1461,2001,2005,,
1407,36820,2,37771,2,951,2000,2003,,
1407,37771,2,38716,2,945,2003,2005,,
1408,37397,6,38716,6,1319,2002,2005,,
1409,37032,2,37559,2,527,2001,2002,,
1409,37559,2,38716,2,1157,2002,2005,,
1410,37164,2,38716,2,1552,2001,2005,,
1411,37559,6,38351,5,792,2002,2004,,
1411,38351,5,38716,5,365,2004,2005,,
1412,36310,4,37255,4,945,1999,2001,,
1412,37255,4,38716,4,1461,2001,2005,,
1413,36667,4,38128,4,1461,2000,2004,,
1413,38128,4,38137,5,9,2004,2004,,
1413,38137,5,38686,4,549,2004,2005,,
1413,38686,4,38716,4,30,2005,2005,,
1414,36524,4,38716,4,2192,1999,2005,,
1415,36301,5,37894,6,1593,1999,2003,,
1415,37894,6,38716,6,822,2003,2005,,
1416,38347,3,38716,3,369,2004,2005,,
1417,37831,6,38716,6,885,2003,2005,,
1418,37400,2,38716,2,1316,2002,2005,,
1419,37041,2,37559,4,518,2001,2002,,
1419,37559,4,37620,3,61,2002,2002,,
1419,37620,3,38716,4,1096,2002,2005,,
1419,37620,4,38716,5,1096,2002,2005,,
1419,37620,5,38716,6,1096,2002,2005,,
1419,37620,6,38134,5,514,2002,2004,,
1419,38134,5,38716,5,582,2004,2005,,
1420,36524,3,38716,3,2192,1999,2005,,
1424,36890,7,38716,8,1826,2000,2005,,
1425,36676,3,37397,4,721,2000,2002,,
1425,37397,4,38716,4,1319,2002,2005,,
1427,36820,6,37255,6,435,2000,2001,,
1427,37255,6,38168,7,913,2001,2004,,
1427,38168,7,38351,6,183,2004,2004,,
1427,38351,6,38716,6,365,2004,2005,,
1428,36890,5,38716,8,1826,2000,2005,,
1428,36890,8,38716,8,1826,2000,2005,,
1429,37771,5,38716,5,945,2003,2005,,
1430,37762,3,38716,3,954,2003,2005,,
1431,37036,4,37102,7,66,2001,2001,,
1431,37102,7,37977,5,875,2001,2003,,
1431,37977,5,37985,6,8,2003,2003,,
1431,37985,6,38128,4,143,2003,2004,,
1431,38128,4,38493,4,365,2004,2005,,
1431,38493,4,38716,4,223,2005,2005,,
1432,37041,4,37406,4,365,2001,2002,,
1432,37406,4,38716,5,1310,2002,2005,,
1432,37406,5,38716,6,1310,2002,2005,,
1432,37406,6,37520,4,114,2002,2002,,
1432,37520,4,37985,6,465,2002,2003,,
1432,37985,6,38135,5,150,2003,2004,,
1432,38135,5,38223,3,88,2004,2004,,
1432,38223,3,38716,3,493,2004,2005,,
1434,37406,4,37458,5,52,2002,2002,,
1434,37458,5,37529,4,71,2002,2002,,
1434,37529,4,37559,3,30,2002,2002,,
1434,37559,3,38716,3,1157,2002,2005,,
1435,37216,4,38716,4,1500,2001,2005,,
1437,36524,2,37832,3,1308,1999,2003,,
1437,37832,3,38251,3,419,2003,2004,,
1437,38251,3,38716,3,465,2004,2005,,
1438,36790,4,38716,4,1926,2000,2005,,
1439,36310,6,38716,6,2406,1999,2005,,
1439,36310,6,36667,5,357,1999,2000,,
1439,36667,5,36799,6,132,2000,2000,,
1439,36799,6,37033,5,234,2000,2001,,
1439,37033,5,38716,5,1683,2001,2005,,
1440,36728,7,37041,8,313,2000,2001,,
1441,36734,2,37255,2,521,2000,2001,,
1441,37255,2,38716,2,1461,2001,2005,,
1442,37255,3,37529,4,274,2001,2002,,
1442,37529,4,38128,4,599,2002,2004,,
1442,38128,4,38716,4,588,2004,2005,,
1443,37620,4,38716,4,1096,2002,2005,,
1444,36301,4,37397,5,1096,1999,2002,,
1444,37397,5,37769,4,372,2002,2003,,
1444,37769,4,38716,4,947,2003,2005,,
1445,36310,3,36860,2,550,1999,2000,,
1445,36860,2,38716,2,1856,2000,2005,,
1446,36676,7,36737,7,61,2000,2000,,
1448,36362,7,38168,6,1806,1999,2004,,
1448,38168,6,38716,6,548,2004,2005,,
1449,36676,4,37559,4,883,2000,2002,,
1451,36524,6,37032,6,508,1999,2001,,
1451,37032,6,37397,7,365,2001,2002,,
1452,37034,3,38128,3,1094,2001,2004,,
1452,38128,3,38716,3,588,2004,2005,,
1454,37771,8,37985,7,214,2003,2003,,
1456,36494,3,37255,4,761,1999,2001,,
1456,37255,4,38716,4,1461,2001,2005,,
1457,36524,3,36676,4,152,1999,2000,,
1457,36676,4,36820,4,144,2000,2000,,
1457,36820,4,37032,5,212,2000,2001,,
1457,37032,5,37400,5,368,2001,2002,,
1457,37400,5,38137,5,737,2002,2004,,
1457,38137,5,38493,5,356,2004,2005,,
1457,38493,5,38716,5,223,2005,2005,,
1458,36463,3,38128,4,1665,1999,2004,,
1458,38128,4,38716,4,588,2004,2005,,
1460,36524,4,37397,4,873,1999,2002,,
1461,37771,4,38716,4,945,2003,2005,,
1462,36759,4,38716,4,1957,2000,2005,,
1463,36698,3,38716,3,2018,2000,2005,,
1464,36310,5,36393,4,83,1999,1999,,
1464,36393,4,36698,4,305,1999,2000,,
1464,36698,4,37157,4,459,2000,2001,,
1464,37157,4,38716,4,1559,2001,2005,,
1465,36454,4,37225,4,771,1999,2001,,
1465,37225,4,38716,4,1491,2001,2005,,
1466,36310,4,38716,4,2406,1999,2005,,
1467,36667,3,37428,3,761,2000,2002,,
1467,37428,3,38716,3,1288,2002,2005,,
1468,36341,4,36860,5,519,1999,2000,,
1468,36860,5,36890,5,30,2000,2000,,
1468,36890,5,37072,6,182,2000,2001,,
1468,37072,6,37590,6,518,2001,2002,,
1468,37590,6,38716,6,1126,2002,2005,,
1469,37041,2,38716,2,1675,2001,2005,,
1471,38290,2,38716,2,426,2004,2005,,
1472,36524,5,36759,6,235,1999,2000,,
1472,36759,6,38716,6,1957,2000,2005,,
1473,37863,3,38716,3,853,2003,2005,,
1475,36829,2,37406,1,577,2000,2002,,
1476,36759,6,37255,5,496,2000,2001,,
1476,37255,5,37620,5,365,2001,2002,,
1476,37620,5,38159,5,539,2002,2004,,
1476,38159,5,38716,5,557,2004,2005,,
1477,36310,3,37069,4,759,1999,2001,,
1477,37069,4,37072,4,3,2001,2001,,
1477,37072,4,38655,4,1583,2001,2005,,
1477,38655,4,38716,4,61,2005,2005,,
1479,36310,4,38655,4,2345,1999,2005,,
1479,38655,4,38716,4,61,2005,2005,,
1480,37035,3,38716,3,1681,2001,2005,,
1482,37771,4,37955,4,184,2003,2003,,
1482,37955,4,38716,4,761,2003,2005,,
1484,37762,4,37771,4,9,2003,2003,,
1484,37771,4,38716,4,945,2003,2005,,
1485,38229,5,38493,6,264,2004,2005,,
1485,38493,6,38716,6,223,2005,2005,,
1486,36829,4,37255,3,426,2000,2001,,
1486,37255,3,38716,3,1461,2001,2005,,
1487,37955,6,38716,6,761,2003,2005,,
1488,37620,4,38716,4,1096,2002,2005,,
1489,36454,6,37041,7,587,1999,2001,,
1489,37041,7,37458,8,417,2001,2002,,
1489,37458,8,37559,8,101,2002,2002,,
1490,37985,3,38716,3,731,2003,2005,,
1491,36310,5,36433,5,123,1999,1999,,
1491,36433,5,37771,6,1338,1999,2003,,
1491,37771,6,38655,5,884,2003,2005,,
1491,38655,5,38716,5,61,2005,2005,,
1493,37032,4,38716,4,1684,2001,2005,,
1494,36799,2,38716,2,1917,2000,2005,,
1495,37985,5,38716,5,731,2003,2005,,
1497,38137,6,38716,6,579,2004,2005,,
1498,37041,5,38716,5,1675,2001,2005,,
1499,36524,4,37620,3,1096,1999,2002,,
1499,37620,3,38716,3,1096,2002,2005,,
1500,36301,5,37032,6,731,1999,2001,,
1500,37032,6,37255,7,223,2001,2001,,
1501,37771,5,38716,5,945,2003,2005,,
1502,37041,4,37398,4,357,2001,2002,,
1502,37398,4,38716,4,1318,2002,2005,,
1503,38229,7,38716,7,487,2004,2005,,
1504,36676,2,38716,2,2040,2000,2005,,
1505,37985,3,38716,3,731,2003,2005,,
1506,37194,4,38351,5,1157,2001,2004,,
1506,38351,5,38716,5,365,2004,2005,,
1507,37437,4,37581,5,144,2002,2002,,
1507,37581,5,38716,5,1135,2002,2005,,
1508,36676,3,37620,4,944,2000,2002,,
1508,37620,4,37885,4,265,2002,2003,,
1508,37885,4,38716,4,831,2003,2005,,
1509,37885,4,38716,4,831,2003,2005,,
1510,38493,6,38716,6,223,2005,2005,,
1511,37194,3,38716,3,1522,2001,2005,,
1514,36890,4,37620,5,730,2000,2002,,
1514,37620,5,38716,6,1096,2002,2005,,
1514,37620,6,38137,6,517,2002,2004,,
1514,38137,6,38716,6,579,2004,2005,,
1517,37976,2,38716,2,740,2003,2005,,
1518,37041,2,38716,2,1675,2001,2005,,
1519,37762,3,38716,3,954,2003,2005,,
1521,37255,4,37559,4,304,2001,2002,,
1521,37559,4,37771,5,212,2002,2003,,
1521,37771,5,38159,3,388,2003,2004,,
1521,38159,3,38716,3,557,2004,2005,,
1522,38502,2,38716,2,214,2005,2005,,
1523,38137,3,38716,3,579,2004,2005,,
1524,38137,3,38716,3,579,2004,2005,,
1525,38137,4,38716,4,579,2004,2005,,
1526,37428,4,38128,4,700,2002,2004,,
1526,38128,4,38716,4,588,2004,2005,,
1527,37041,7,38220,7,1179,2001,2004,,
1528,36301,4,36676,4,375,1999,2000,,
1528,36676,4,38716,4,2040,2000,2005,,
1529,37194,4,37559,5,365,2001,2002,,
1529,37559,5,38716,5,1157,2002,2005,,
1530,36667,5,37164,5,497,2000,2001,,
1530,37164,5,37255,4,91,2001,2001,,
1530,37255,4,38716,4,1461,2001,2005,,
1531,36396,4,38290,4,1894,1999,2004,,
1531,38290,4,38716,4,426,2004,2005,,
1532,37762,4,38716,4,954,2003,2005,,
1533,37620,4,38716,4,1096,2002,2005,,
1534,36402,4,36667,3,265,1999,2000,,
1534,36667,3,38137,3,1470,2000,2004,,
1534,38137,3,38716,3,579,2004,2005,,
1536,37406,3,38716,3,1310,2002,2005,,
1538,36890,3,37255,3,365,2000,2001,,
1538,37255,3,38716,3,1461,2001,2005,,
1539,37620,5,38716,5,1096,2002,2005,,
1540,37039,3,38716,3,1677,2001,2005,,
1541,37458,1,38716,1,1258,2002,2005,,
1542,36667,3,37255,1,588,2000,2001,,
1543,36524,4,37225,4,701,1999,2001,,
1543,37225,4,38716,4,1491,2001,2005,,
1544,36676,3,38128,3,1452,2000,2004,,
1544,38128,3,38716,3,588,2004,2005,,
1546,36303,6,36524,5,221,1999,1999,,
1548,36667,2,37397,3,730,2000,2002,,
1548,37397,3,38716,3,1319,2002,2005,,
1549,37985,5,38716,6,731,2003,2005,,
1549,37985,6,38716,6,731,2003,2005,,
1550,37985,3,38251,3,266,2003,2004,,
1550,38251,3,38716,3,465,2004,2005,,
1552,36667,5,36728,7,61,2000,2000,,
1552,36728,7,36890,8,162,2000,2000,,
1552,36890,8,38716,7,1826,2000,2005,,
1553,36310,4,38251,4,1941,1999,2004,,
1553,38251,4,38716,4,465,2004,2005,,
1555,38351,2,38716,2,365,2004,2005,,
1558,36310,6,36768,7,458,1999,2000,,
1558,36768,7,37072,7,304,2000,2001,,
1558,37072,7,37133,7,61,2001,2001,,
1558,37133,7,37401,8,268,2001,2002,,
1558,37401,8,38128,7,727,2002,2004,,
1558,38128,7,38351,7,223,2004,2004,,
1558,38351,7,38716,7,365,2004,2005,,
1559,36667,3,37037,3,370,2000,2001,,
1559,37037,3,37620,3,583,2001,2002,,
1561,36676,3,37185,3,509,2000,2001,,
1561,37185,3,37194,3,9,2001,2001,,
1562,36701,5,38351,5,1650,2000,2004,,
1562,38351,5,38594,5,243,2004,2005,,
1562,38594,5,38716,5,122,2005,2005,,
1563,36362,6,36424,4,62,1999,1999,,
1563,36424,4,36524,5,100,1999,1999,,
1563,36524,5,36676,6,152,1999,2000,,
1563,36676,6,38716,7,2040,2000,2005,,
1563,36676,7,36890,7,214,2000,2000,,
1563,36890,7,37063,7,173,2000,2001,,
1563,37063,7,37985,7,922,2001,2003,,
1563,37985,7,38131,7,146,2003,2004,,
1563,38131,7,38716,7,585,2004,2005,,
1565,37034,2,37041,2,7,2001,2001,,
1565,37041,2,38716,2,1675,2001,2005,,
1566,37590,4,38493,4,903,2002,2005,,
1566,38493,4,38716,4,223,2005,2005,,
1568,36524,5,37155,6,631,1999,2001,,
1568,37155,6,37216,8,61,2001,2001,,
1569,36306,3,38716,3,2410,1999,2005,,
1570,37255,3,37860,3,605,2001,2003,,
1570,37860,3,38716,3,856,2003,2005,,
1571,36433,3,38716,3,2283,1999,2005,,
1573,37467,4,38716,4,1249,2002,2005,,
1574,37255,3,37397,4,142,2001,2002,,
1574,37397,4,37985,4,588,2002,2003,,
1574,37985,4,38716,4,731,2003,2005,,
1575,36402,7,37041,6,639,1999,2001,,
1575,37041,6,37467,6,426,2001,2002,,
1575,37467,6,37863,5,396,2002,2003,,
1575,37863,5,38493,5,630,2003,2005,,
1575,38493,5,38716,5,223,2005,2005,,
1576,37032,4,38312,5,1280,2001,2004,,
1576,38312,5,38716,5,404,2004,2005,,
1578,36667,2,37255,2,588,2000,2001,,
1578,37255,2,38716,2,1461,2001,2005,,
1579,36669,2,38716,2,2047,2000,2005,,
1581,37041,3,37072,3,31,2001,2001,,
1581,37072,3,37520,4,448,2001,2002,,
1581,37520,4,38716,5,1196,2002,2005,,
1582,38312,4,38716,4,404,2004,2005,,
1583,36890,3,38716,3,1826,2000,2005,,
1585,37102,5,38716,5,1614,2001,2005,,
1586,37032,4,37039,7,7,2001,2001,,
1586,37039,7,37498,5,459,2001,2002,,
1586,37498,5,37823,4,325,2002,2003,,
1589,36402,2,36707,2,305,1999,2000,,
1589,36707,2,36820,3,113,2000,2000,,
1589,36820,3,37041,3,221,2000,2001,,
1589,37041,3,37072,3,31,2001,2001,,
1589,37072,3,38137,4,1065,2001,2004,,
1589,38137,4,38716,4,579,2004,2005,,
1590,37255,3,37985,3,730,2001,2003,,
1590,37985,3,38716,3,731,2003,2005,,
1591,36494,6,36524,6,30,1999,1999,,
1591,36524,6,37127,7,603,1999,2001,,
1591,37127,7,37985,6,858,2001,2003,,
1591,37985,6,38351,6,366,2003,2004,,
1591,38351,6,38716,6,365,2004,2005,,
1592,36524,4,37041,4,517,1999,2001,,
1592,37041,4,37406,4,365,2001,2002,,
1592,37406,4,37767,3,361,2002,2003,,
1593,36524,3,37458,3,934,1999,2002,,
1593,37458,3,38716,3,1258,2002,2005,,
1595,37620,3,37985,2,365,2002,2003,,
1595,37985,2,38716,2,731,2003,2005,,
1596,36309,3,36332,3,23,1999,1999,,
1596,36332,3,37255,3,923,1999,2001,,
1596,37255,3,38716,3,1461,2001,2005,,
1597,36301,3,36304,3,3,1999,1999,,
1597,36304,3,37255,2,951,1999,2001,,
1598,36306,3,36524,3,218,1999,1999,,
1598,36524,3,38351,3,1827,1999,2004,,
1598,38351,3,38716,3,365,2004,2005,,
1599,36890,3,38716,3,1826,2000,2005,,
1600,36341,5,37771,4,1430,1999,2003,,
1600,37771,4,38716,4,945,2003,2005,,
1601,36362,5,38716,5,2354,1999,2005,,
1602,38198,6,38716,6,518,2004,2005,,
1604,37802,3,38128,4,326,2003,2004,,
1604,38128,4,38716,4,588,2004,2005,,
1605,37255,2,37437,3,182,2001,2002,,
1605,37437,3,38716,3,1279,2002,2005,,
1606,37093,3,37611,3,518,2001,2002,,
1606,37611,3,38716,3,1105,2002,2005,,
1607,38502,4,38716,4,214,2005,2005,,
1608,37762,2,38716,2,954,2003,2005,,
1610,37581,6,37793,6,212,2002,2003,,
1610,37793,6,38716,6,923,2003,2005,,
1612,36890,5,37498,5,608,2000,2002,,
1615,37406,4,38716,5,1310,2002,2005,,
1615,37406,5,38716,5,1310,2002,2005,,
1617,37164,4,38716,4,1552,2001,2005,,
1618,37620,4,38251,4,631,2002,2004,,
1618,38251,4,38625,5,374,2004,2005,,
1618,38625,5,38716,5,91,2005,2005,,
1619,36485,3,37397,4,912,1999,2002,,
1619,37397,4,38351,4,954,2002,2004,,
1619,38351,4,38499,5,148,2004,2005,,
1619,38499,5,38716,5,217,2005,2005,,
1620,38220,3,38716,3,496,2004,2005,,
1621,37985,2,38716,2,731,2003,2005,,
1622,37255,5,37985,6,730,2001,2003,,
1622,37985,6,38716,6,731,2003,2005,,
1623,36362,4,36672,5,310,1999,2000,,
1623,36672,5,36676,5,4,2000,2000,,
1623,36676,5,36890,6,214,2000,2000,,
1623,36890,6,38281,5,1391,2000,2004,,
1623,38281,5,38716,5,435,2004,2005,,
1625,36332,3,36790,3,458,1999,2000,,
1625,36790,3,37985,2,1195,2000,2003,,
1625,37985,2,38716,2,731,2003,2005,,
1626,36310,3,36766,3,456,1999,2000,,
1626,36766,3,37985,3,1219,2000,2003,,
1626,37985,3,38716,3,731,2003,2005,,
1628,38128,2,38716,2,588,2004,2005,,
1629,37405,3,37620,3,215,2002,2002,,
1629,37620,3,38716,3,1096,2002,2005,,
1630,36524,6,38351,5,1827,1999,2004,,
1630,38351,5,38716,5,365,2004,2005,,
1633,37620,3,38716,3,1096,2002,2005,,
1634,36494,6,36676,7,182,1999,2000,,
1635,36301,2,38716,2,2415,1999,2005,,
1636,37397,5,37406,6,9,2002,2002,,
1636,37406,6,38716,6,1310,2002,2005,,
1637,37041,8,37194,6,153,2001,2001,,
1637,37194,6,38137,7,943,2001,2004,,
1637,38137,7,38716,7,579,2004,2005,,
1638,37763,3,38260,2,497,2003,2004,,
1638,38260,2,38716,2,456,2004,2005,,
1639,36759,3,37797,3,1038,2000,2003,,
1639,37797,3,38716,3,919,2003,2005,,
1640,38563,2,38716,2,153,2005,2005,,
1641,37124,2,38594,2,1470,2001,2005,,
1641,38594,2,38716,2,122,2005,2005,,
1642,38493,2,38716,2,223,2005,2005,,
1643,37401,1,38716,1,1315,2002,2005,,
1644,37255,3,38716,3,1461,2001,2005,,
1646,37032,3,38716,3,1684,2001,2005,,
1647,38351,3,38716,3,365,2004,2005,,
1648,37039,5,37762,5,723,2001,2003,,
1648,37762,5,38351,4,589,2003,2004,,
1648,38351,4,38716,4,365,2004,2005,,
1649,37255,4,38716,4,1461,2001,2005,,
1650,37985,2,38351,1,366,2003,2004,,
1650,38351,1,38716,1,365,2004,2005,,
1651,37406,3,38716,3,1310,2002,2005,,
1652,36820,3,37489,2,669,2000,2002,,
1652,37489,2,38716,2,1227,2002,2005,,
1653,36707,2,37771,2,1064,2000,2003,,
1653,37771,2,38189,3,418,2003,2004,,
1653,38189,3,38716,3,527,2004,2005,,
1654,38493,4,38716,4,223,2005,2005,,
1656,37041,4,37406,4,365,2001,2002,,
1656,37406,4,37769,5,363,2002,2003,,
1656,37769,5,38716,5,947,2003,2005,,
1657,37406,3,38189,2,783,2002,2004,,
1657,38189,2,38716,2,527,2004,2005,,
1658,37255,4,38716,4,1461,2001,2005,,
1659,36676,2,37771,2,1095,2000,2003,,
1659,37771,2,38137,3,366,2003,2004,,
1659,38137,3,38716,3,579,2004,2005,,
1660,37041,7,37397,5,356,2001,2002,,
1660,37397,5,37950,4,553,2002,2003,,
1660,37950,4,38137,4,187,2003,2004,,
1660,38137,4,38716,4,579,2004,2005,,
1662,36790,3,37550,4,760,2000,2002,,
1662,37550,4,38716,4,1166,2002,2005,,
1663,37041,3,38716,3,1675,2001,2005,,
1664,36341,3,36454,4,113,1999,1999,,
1664,36454,4,37620,4,1166,1999,2002,,
1664,37620,4,37955,6,335,2002,2003,,
1664,37955,6,38716,6,761,2003,2005,,
1665,36485,4,37520,4,1035,1999,2002,,
1665,37520,4,37620,5,100,2002,2002,,
1665,37620,5,37762,7,142,2002,2003,,
1665,37762,7,38716,7,954,2003,2005,,
1666,36524,2,37802,2,1278,1999,2003,,
1666,37802,2,38137,3,335,2003,2004,,
1666,38137,3,38189,3,52,2004,2004,,
1666,38189,3,38716,3,527,2004,2005,,
1667,36310,2,37762,3,1452,1999,2003,,
1667,37762,3,38128,3,366,2003,2004,,
1667,38128,3,38716,3,588,2004,2005,,
1668,37985,3,38716,3,731,2003,2005,,
1669,38351,6,38716,6,365,2004,2005,,
1670,36424,4,37406,4,982,1999,2002,,
1670,37406,4,38716,4,1310,2002,2005,,
1671,36424,5,36829,4,405,1999,2000,,
1671,36829,4,37397,4,568,2000,2002,,
1671,37397,4,38716,4,1319,2002,2005,,
1672,36890,4,37032,4,142,2000,2001,,
1672,37032,4,37620,5,588,2001,2002,,
1672,37620,5,37955,6,335,2002,2003,,
1672,37955,6,38137,6,182,2003,2004,,
1672,38137,6,38716,6,579,2004,2005,,
1673,36371,3,38716,3,2345,1999,2005,,
1676,36524,2,37762,3,1238,1999,2003,,
1676,37762,3,38159,3,397,2003,2004,,
1676,38159,3,38716,3,557,2004,2005,,
1677,36524,2,37863,3,1339,1999,2003,,
1677,37863,3,38159,3,296,2003,2004,,
1677,38159,3,38716,3,557,2004,2005,,
1678,36301,3,38716,3,2415,1999,2005,,
1679,36341,2,37762,2,1421,1999,2003,,
1679,37762,2,38159,3,397,2003,2004,,
1679,38159,3,38351,3,192,2004,2004,,
1679,38351,3,38716,3,365,2004,2005,,
1680,36698,3,37771,4,1073,2000,2003,,
1680,37771,4,38716,4,945,2003,2005,,
1681,37102,4,37406,5,304,2001,2002,,
1681,37406,5,38716,5,1310,2002,2005,,
1682,36759,4,37397,5,638,2000,2002,,
1682,37397,5,37406,6,9,2002,2002,,
1682,37406,6,38716,6,1310,2002,2005,,
1682,37406,6,38189,6,783,2002,2004,,
1682,38189,6,38716,6,527,2004,2005,,
1684,36890,3,37620,4,730,2000,2002,,
1684,37620,4,38716,4,1096,2002,2005,,
1685,36524,5,36799,4,275,1999,2000,,
1685,36799,4,37559,4,760,2000,2002,,
1685,37559,4,38502,4,943,2002,2005,,
1685,38502,4,38716,4,214,2005,2005,,
1686,37255,1,38716,1,1461,2001,2005,,
1687,36890,2,38716,2,1826,2000,2005,,
1688,36737,3,38716,3,1979,2000,2005,,
1689,38137,3,38716,3,579,2004,2005,,
1690,36301,2,38716,2,2415,1999,2005,,
1691,37041,3,38168,3,1127,2001,2004,,
1691,38168,3,38716,3,548,2004,2005,,
1692,36371,3,37255,3,884,1999,2001,,
1692,37255,3,38281,2,1026,2001,2004,,
1692,38281,2,38716,2,435,2004,2005,,
1693,36301,3,36402,3,101,1999,1999,,
1694,36890,4,37397,4,507,2000,2002,,
1694,37397,4,38716,5,1319,2002,2005,,
1694,37397,5,38716,5,1319,2002,2005,,
1694,37397,5,37985,5,588,2002,2003,,
1697,37620,3,38716,3,1096,2002,2005,,
1699,38260,4,38716,4,456,2004,2005,,
1699,38716,4,38716,4,0,2005,2005,,
1700,36524,6,37406,6,882,1999,2002,,
1700,37406,6,38716,6,1310,2002,2005,,
1701,36524,3,37225,3,701,1999,2001,,
1701,37225,3,38716,3,1491,2001,2005,,
1703,37428,3,38716,3,1288,2002,2005,,
1704,36310,5,36524,5,214,1999,1999,,
1704,36524,5,37946,6,1422,1999,2003,,
1704,37946,6,38716,6,770,2003,2005,,
1706,37406,2,38716,2,1310,2002,2005,,
1707,37620,1,38716,1,1096,2002,2005,,
1708,37032,3,38716,3,1684,2001,2005,,
1709,36301,7,36424,7,123,1999,1999,,
1709,37255,8,38716,8,1461,2001,2005,,
1710,37620,3,38716,3,1096,2002,2005,,
1711,36676,3,38716,3,2040,2000,2005,,
1712,37620,3,37985,4,365,2002,2003,,
1713,37041,2,37155,3,114,2001,2001,,
1713,37155,3,37397,3,242,2001,2002,,
1713,37397,3,37406,5,9,2002,2002,,
1713,37406,5,37489,6,83,2002,2002,,
1713,37489,6,37529,4,40,2002,2002,,
1713,37529,4,37620,4,91,2002,2002,,
1713,37620,4,38351,5,731,2002,2004,,
1713,38351,5,38716,5,365,2004,2005,,
1714,37255,4,38222,4,967,2001,2004,,
1714,38222,4,38716,4,494,2004,2005,,
1715,36301,3,38351,3,2050,1999,2004,,
1715,38351,3,38716,3,365,2004,2005,,
1719,38351,3,38716,3,365,2004,2005,,
1720,38493,3,38716,3,223,2005,2005,,
1721,38493,3,38716,3,223,2005,2005,,
1722,36310,3,38716,3,2406,1999,2005,,
1723,36304,3,38312,3,2008,1999,2004,,
1723,38312,3,38716,3,404,2004,2005,,
1725,38321,5,38716,5,395,2004,2005,,
1726,37832,4,38351,3,519,2003,2004,,
1726,38351,3,38716,3,365,2004,2005,,
1727,37397,2,38716,2,1319,2002,2005,,
1728,36393,6,36463,5,70,1999,1999,,
1728,36463,5,36524,5,61,1999,1999,,
1728,36524,5,38260,5,1736,1999,2004,,
1728,38260,5,38716,5,456,2004,2005,,
1729,36820,2,38716,2,1896,2000,2005,,
1730,37437,3,37985,3,548,2002,2003,,
1730,37985,3,38716,3,731,2003,2005,,
1732,36524,7,36890,8,366,1999,2000,,
1732,37133,8,38716,8,1583,2001,2005,,
1734,36829,4,37823,4,994,2000,2003,,
1734,37823,4,38351,4,528,2003,2004,,
1734,38351,4,38716,4,365,2004,2005,,
1735,37397,6,38251,6,854,2002,2004,,
1735,38251,6,38312,6,61,2004,2004,,
1735,38312,6,38716,6,404,2004,2005,,
1736,36310,2,37406,1,1096,1999,2002,,
1736,37406,1,38716,1,1310,2002,2005,,
1737,36365,2,36667,2,302,1999,2000,,
1737,36667,2,37762,2,1095,2000,2003,,
1737,37762,2,38716,2,954,2003,2005,,
1738,37255,2,38290,2,1035,2001,2004,,
1738,38290,2,38716,2,426,2004,2005,,
1740,38351,4,38716,4,365,2004,2005,,
1741,37489,3,37924,4,435,2002,2003,,
1741,37924,4,38128,4,204,2003,2004,,
1741,38128,4,38716,4,588,2004,2005,,
1742,37164,3,37620,4,456,2001,2002,,
1742,37620,4,38135,5,515,2002,2004,,
1742,38135,5,38716,5,581,2004,2005,,
1744,36402,3,37620,3,1218,1999,2002,,
1744,37620,3,38716,3,1096,2002,2005,,
1745,36402,3,36890,3,488,1999,2000,,
1745,36890,3,37041,4,151,2000,2001,,
1745,37041,4,37093,4,52,2001,2001,,
1745,37093,4,37620,4,527,2001,2002,,
1745,37620,4,38502,4,882,2002,2005,,
1745,38502,4,38716,4,214,2005,2005,,
1746,36860,3,37771,4,911,2000,2003,,
1746,37771,4,38716,4,945,2003,2005,,
1748,36463,4,37404,4,941,1999,2002,,
1748,37404,4,38716,4,1312,2002,2005,,
1749,37032,3,37093,4,61,2001,2001,,
1749,37093,4,37397,4,304,2001,2002,,
1749,37397,4,38716,4,1319,2002,2005,,
1749,37397,4,37406,5,9,2002,2002,,
1749,37406,5,38288,5,882,2002,2004,,
1749,38288,5,38493,5,205,2004,2005,,
1749,38493,5,38716,4,223,2005,2005,,
1749,38493,4,38716,4,223,2005,2005,,
1750,36524,4,37428,5,904,1999,2002,,
1750,37428,5,37863,6,435,2002,2003,,
1750,37863,6,38716,6,853,2003,2005,,
1752,36524,5,37406,6,882,1999,2002,,
1752,37406,6,37620,6,214,2002,2002,,
1752,37620,6,38716,6,1096,2002,2005,,
1753,37041,2,38716,2,1675,2001,2005,,
1754,36820,3,38716,3,1896,2000,2005,,
1755,37124,2,38716,2,1592,2001,2005,,
1756,36341,5,37216,4,875,1999,2001,,
1756,37216,4,38132,4,916,2001,2004,,
1756,38132,4,38716,4,584,2004,2005,,
1757,37194,2,37769,3,575,2001,2003,,
1757,37769,3,37771,4,2,2003,2003,,
1757,38321,3,38716,3,395,2004,2005,,
1758,37613,4,37985,4,372,2002,2003,,
1758,37985,4,38716,4,731,2003,2005,,
1759,36667,3,38716,3,2049,2000,2005,,
1760,37397,5,37406,4,9,2002,2002,,
1760,37406,4,37762,4,356,2002,2003,,
1760,37762,4,38716,4,954,2003,2005,,
1761,37581,5,37793,6,212,2002,2003,,
1761,37793,6,37955,6,162,2003,2003,,
1761,37955,6,38716,6,761,2003,2005,,
1761,37955,6,38716,6,761,2003,2005,,
1762,36851,3,38716,3,1865,2000,2005,,
1763,37550,5,38716,5,1166,2002,2005,,
1764,37620,4,38716,4,1096,2002,2005,,
1765,36524,6,36768,6,244,1999,2000,,
1766,36301,3,37102,3,801,1999,2001,,
1766,37102,3,38716,3,1614,2001,2005,,
1767,36829,4,37985,4,1156,2000,2003,,
1767,37985,4,38716,4,731,2003,2005,,
1769,37854,5,38716,5,862,2003,2005,,
1770,37225,4,37762,4,537,2001,2003,,
1770,37762,4,38281,4,519,2003,2004,,
1770,38281,4,38716,4,435,2004,2005,,
1771,36676,3,38716,3,2040,2000,2005,,
1772,38351,4,38716,4,365,2004,2005,,
1773,37032,4,37771,4,739,2001,2003,,
1773,37771,4,38716,4,945,2003,2005,,
1774,36494,4,36890,3,396,1999,2000,,
1775,36371,4,36890,3,519,1999,2000,,
1776,36424,6,36463,6,39,1999,1999,,
1776,36463,6,36675,7,212,1999,2000,,
1776,37032,7,37559,8,527,2001,2002,,
1778,36310,3,36667,2,357,1999,2000,,
1779,36890,5,37093,4,203,2000,2001,,
1779,37093,4,38716,4,1623,2001,2005,,
1781,36698,6,38716,6,2018,2000,2005,,
1782,38342,3,38716,3,374,2004,2005,,
1783,37397,3,38716,3,1319,2002,2005,,
1785,37255,4,38716,4,1461,2001,2005,,
1786,37406,4,38716,5,1310,2002,2005,,
1786,37406,5,37620,6,214,2002,2002,,
1786,37620,6,38128,5,508,2002,2004,,
1786,38128,5,38137,5,9,2004,2004,,
1786,38137,5,38351,4,214,2004,2004,,
1786,38351,4,38716,4,365,2004,2005,,
1787,36524,3,37437,4,913,1999,2002,,
1787,37437,4,38716,4,1279,2002,2005,,
1788,37133,4,37255,3,122,2001,2001,,
1788,37255,3,38198,4,943,2001,2004,,
1788,38198,4,38220,3,22,2004,2004,,
1788,38220,3,38351,3,131,2004,2004,,
1788,38351,3,38716,3,365,2004,2005,,
1789,37041,4,38137,3,1096,2001,2004,,
1789,38137,3,38716,3,579,2004,2005,,
1790,36301,3,38251,3,1950,1999,2004,,
1790,38251,3,38716,3,465,2004,2005,,
1791,36301,7,36890,7,589,1999,2000,,
1792,36768,3,37185,4,417,2000,2001,,
1792,37185,4,37404,4,219,2001,2002,,
1792,37404,4,38128,5,724,2002,2004,,
1792,38128,5,38716,5,588,2004,2005,,
1793,37771,1,38716,1,945,2003,2005,,
1794,37766,1,38716,1,950,2003,2005,,
1795,37771,1,38716,1,945,2003,2005,,
1797,36524,3,36829,3,305,1999,2000,,
1797,36829,3,37620,2,791,2000,2002,,
1798,38502,2,38686,2,184,2005,2005,,
1798,38686,2,38716,2,30,2005,2005,,
1800,36310,3,37620,3,1310,1999,2002,,
1800,37620,3,38716,3,1096,2002,2005,,
1801,38128,3,38716,3,588,2004,2005,,
1802,37406,7,37620,4,214,2002,2002,,
1802,37620,4,38716,6,1096,2002,2005,,
1802,37620,6,37823,6,203,2002,2003,,
1802,37823,6,37985,6,162,2003,2003,,
1802,37985,6,38716,6,731,2003,2005,,
1803,36332,5,36524,6,192,1999,1999,,
1803,36524,6,37032,6,508,1999,2001,,
1803,37032,6,37823,7,791,2001,2003,,
1803,37823,7,38716,7,893,2003,2005,,
1804,37397,5,37406,4,9,2002,2002,,
1804,37406,4,37550,6,144,2002,2002,,
1804,37550,6,37762,6,212,2002,2003,,
1804,37762,6,38281,5,519,2003,2004,,
1804,38281,5,38716,5,435,2004,2005,,
1805,36676,6,37590,7,914,2000,2002,,
1805,37590,7,37771,8,181,2002,2003,,
1805,37771,8,37985,7,214,2003,2003,,
1805,37985,7,38137,7,152,2003,2004,,
1805,38137,7,38220,7,83,2004,2004,,
1805,38220,7,38716,7,496,2004,2005,,
1806,36524,4,38716,4,2192,1999,2005,,
1807,36676,7,38716,7,2040,2000,2005,,
1808,38351,6,38716,6,365,2004,2005,,
1809,37590,6,37766,7,176,2002,2003,,
1809,37766,7,38716,7,950,2003,2005,,
1810,36301,5,37620,6,1319,1999,2002,,
1810,37620,6,38128,5,508,2002,2004,,
1810,38128,5,38716,5,588,2004,2005,,
1812,36362,6,37032,6,670,1999,2001,,
1813,37620,3,38716,3,1096,2002,2005,,
1814,36820,2,38716,2,1896,2000,2005,,
1815,37620,3,38716,3,1096,2002,2005,,
1816,37185,5,37985,5,800,2001,2003,,
1816,37985,5,38716,5,731,2003,2005,,
1818,37397,2,38716,2,1319,2002,2005,,
1819,36301,4,37032,4,731,1999,2001,,
1819,37032,4,37581,4,549,2001,2002,,
1819,37581,4,38351,4,770,2002,2004,,
1819,38351,4,38716,4,365,2004,2005,,
1821,38493,5,38716,5,223,2005,2005,,
1822,36890,4,38716,4,1826,2000,2005,,
1823,37406,4,38716,5,1310,2002,2005,,
1823,37406,5,37559,4,153,2002,2002,,
1823,37559,4,38351,4,792,2002,2004,,
1823,38351,4,38716,4,365,2004,2005,,
1824,37036,2,38716,2,1680,2001,2005,,
1826,38625,2,38716,2,91,2005,2005,,
1829,36524,4,36768,3,244,1999,2000,,
